city,male,female,population,births ,deaths,marriage,divorce
01北海道　　　　　　　 ,2448759,2739682,5188441,148354,338223,105228,45934
0110札幌市保健所　　　 ,911689,1047834,1959523,61408,104874,45914,18555
0136小樽市保健所　　　 ,49869,60823,110692,2156,9665,1566,768
0137市立函館保健所　　 ,113528,136449,249977,6208,20000,4822,2219
0138旭川市保健所　　　 ,151458,176695,328153,9451,23285,6559,2946
0151江別保健所　　　　 ,93428,102191,195619,4881,11507,2575,1544
0153千歳保健所　　　　 ,110886,114044,224930,7126,11074,4738,2102
0154岩見沢保健所　　　 ,71512,80487,151999,3183,12806,2217,1033
0159滝川保健所　　　　 ,46519,52951,99470,2272,9184,1627,684
0161深川保健所　　　　 ,13845,15681,29526,611,2676,405,161
0163富良野保健所　　　 ,19256,20146,39402,1209,2742,815,279
0165名寄保健所　　　　 ,29222,31322,60544,1632,4406,1011,446
0167岩内保健所　　　　 ,9706,10093,19799,549,1742,389,147
0168倶知安保健所　　　 ,32399,33700,66099,1898,5278,1241,484
0169江差保健所　　　　 ,10027,10988,21015,396,1951,281,147
0172渡島保健所　　　　 ,49879,57253,107132,2590,8543,1646,1042
0173八雲保健所　　　　 ,16085,16880,32965,795,2906,547,245
0175室蘭保健所　　　　 ,84248,91414,175662,4479,13888,3108,1380
0176苫小牧保健所　　　 ,100214,104331,204545,6278,12986,4519,2052
0177浦河保健所　　　　 ,9877,10293,20170,521,1557,365,163
0178静内保健所　　　　 ,20732,21512,42244,1147,3246,773,335
0179帯広保健所　　　　 ,158791,171932,330723,10162,21371,6835,2820
0184釧路保健所　　　　 ,104575,116582,221157,5823,15926,4313,2153
0186根室保健所　　　　 ,11717,12610,24327,608,1924,466,187
0187中標津保健所　　　 ,23166,23344,46510,1570,2708,969,501
0188網走保健所　　　　 ,30945,30967,61912,1762,4391,1161,460
0190北見保健所　　　　 ,69172,76275,145447,3936,10150,2672,1311
0192紋別保健所　　　　 ,30653,32917,63570,1699,5375,1143,536
0193稚内保健所　　　　 ,30670,30552,61222,1728,4404,1215,552
0195留萌保健所　　　　 ,20528,22090,42618,1033,3710,732,303
0196上川保健所　　　　 ,24163,27326,51489,1243,3948,604,379
01100札幌市　　　　　　,911689,1047834,1959523,61408,104874,45914,18555
01101札幌市中央区　　　,111470,134557,246027,7787,11704,7557,2569
01102札幌市北区　　　　,135037,151154,286191,8552,14825,5617,2592
01103札幌市東区　　　　,124976,138509,263485,9012,13588,6549,2657
01104札幌市白石区　　　,99486,111245,210731,7890,11101,6726,2479
01105札幌市豊平区　　　,103366,120339,223705,7914,11391,6891,2065
01106札幌市南区　　　　,62042,73071,135113,3144,9174,1950,1102
01107札幌市西区　　　　,99510,116465,215975,7470,11671,5321,1897
01108札幌市厚別区　　　,56469,67944,124413,3059,7038,2063,964
01109札幌市手稲区　　　,66684,75458,142142,3903,8281,1967,1244
01110札幌市清田区　　　,52649,59092,111741,2677,6101,1273,986
01202函館市　　　　　　,113528,136449,249977,6208,20000,4822,2219
01203小樽市　　　　　　,49869,60823,110692,2156,9665,1566,768
01204旭川市　　　　　　,151458,176695,328153,9451,23285,6559,2946
01205室蘭市　　　　　　,40145,41830,81975,2153,6569,1584,616
01206釧路市　　　　　　,77271,86933,164204,4241,11873,3288,1640
01207帯広市　　　　　　,79235,86579,165814,5404,9707,4095,1592
01208北見市　　　　　　,54520,60535,115055,3206,7710,2176,1090
01209夕張市　　　　　　,3373,3874,7247,97,925,75,33
01210岩見沢市　　　　　,36997,42113,79110,1785,5898,1264,576
01211網走市　　　　　　,17967,17471,35438,970,2286,694,289
01212留萌市　　　　　　,9623,10356,19979,508,1607,379,149
01213苫小牧市　　　　　,83048,86313,169361,5523,9853,3981,1794
01214稚内市　　　　　　,16524,16601,33125,905,2200,646,315
01215美唄市　　　　　　,9540,10829,20369,340,2003,283,141
01216芦別市　　　　　　,5758,6780,12538,220,1445,167,72
01217江別市　　　　　　,57163,63207,120370,3097,6690,1581,894
01218赤平市　　　　　　,4355,5276,9631,138,1182,108,50
01219紋別市　　　　　　,9811,10874,20685,499,1648,393,192
01220士別市　　　　　　,8357,9425,17782,371,1369,220,130
01221名寄市　　　　　　,13296,13936,27232,903,1679,585,221
01222三笠市　　　　　　,3621,4404,8025,179,991,114,60
01223根室市　　　　　　,11717,12610,24327,608,1924,466,187
01224千歳市　　　　　　,49460,47786,97246,3701,4178,2709,1002
01225滝川市　　　　　　,18775,20605,39380,1094,2998,841,325
01226砂川市　　　　　　,7592,8865,16457,404,1378,277,116
01227歌志内市　　　　　,1393,1586,2979,34,397,25,12
01228深川市　　　　　　,9311,10618,19929,394,1757,270,114
01229富良野市　　　　　,9871,11028,20899,653,1454,401,137
01230登別市　　　　　　,22063,24148,46211,1216,3337,821,414
01231恵庭市　　　　　　,33863,36022,69885,2163,3590,1329,599
01233伊達市　　　　　　,15144,17502,32646,795,2585,529,255
01234北広島市　　　　　,27563,30236,57799,1262,3306,700,501
01235石狩市　　　　　　,27146,29272,56418,1457,3443,754,539
01236北斗市　　　　　　,20505,23497,44002,1188,2860,774,523
01303当別町　　　　　　,7642,8153,15795,249,1050,196,99
01304新篠津村　　　　　,1477,1559,3036,78,324,44,12
01331松前町　　　　　　,2800,3418,6218,98,804,66,41
01332福島町　　　　　　,1753,2005,3758,64,443,53,20
01333知内町　　　　　　,2052,2052,4104,77,368,66,27
01334木古内町　　　　　,1746,2062,3808,55,436,52,18
01337七飯町　　　　　　,12661,14913,27574,744,2050,391,255
01343鹿部町　　　　　　,1756,1890,3646,78,324,42,28
01345森町　　　　　　　,6606,7416,14022,286,1258,202,130
01346八雲町　　　　　　,7785,7812,15597,447,1185,297,129
01347長万部町　　　　　,2394,2538,4932,113,462,94,37
01361江差町　　　　　　,3558,3851,7409,132,578,112,47
01362上ノ国町　　　　　,1945,2311,4256,70,448,49,26
01363厚沢部町　　　　　,1711,1851,3562,79,344,44,25
01364乙部町　　　　　　,1537,1849,3386,69,355,38,23
01367奥尻町　　　　　　,1276,1126,2402,46,226,38,26
01370今金町　　　　　　,2444,2624,5068,104,482,67,35
01371せたな町　　　　　,3462,3906,7368,131,777,89,44
01391島牧村　　　　　　,686,668,1354,33,145,28,6
01392寿都町　　　　　　,1394,1390,2784,70,251,45,16
01393黒松内町　　　　　,1348,1427,2775,61,275,47,10
01394蘭越町　　　　　　,2175,2355,4530,126,422,56,35
01395ニセコ町　　　　　,2458,2369,4827,183,285,126,31
01396真狩村　　　　　　,1006,1002,2008,76,156,40,16
01397留寿都村　　　　　,923,875,1798,56,103,37,11
01398喜茂別町　　　　　,1093,1000,2093,52,214,34,14
01399京極町　　　　　　,1411,1477,2888,74,253,46,20
01400倶知安町　　　　　,7368,7062,14430,578,730,414,139
01401共和町　　　　　　,3044,2719,5763,213,407,143,29
01402岩内町　　　　　　,5479,6122,11601,287,1061,206,101
01403泊村　　　　　　　,784,782,1566,35,170,33,14
01404神恵内村　　　　　,399,470,869,14,104,7,3
01405積丹町　　　　　　,851,976,1827,35,204,20,8
01406古平町　　　　　　,1301,1391,2692,36,329,29,18
01407仁木町　　　　　　,1504,1609,3113,76,313,35,21
01408余市町　　　　　　,8308,9567,17875,411,1516,250,126
01409赤井川村　　　　　,573,532,1105,31,82,34,13
01423南幌町　　　　　　,3458,3815,7273,153,468,72,51
01424奈井江町　　　　　,2390,2702,5092,96,507,62,38
01425上砂川町　　　　　,1281,1543,2824,57,381,37,18
01427由仁町　　　　　　,2292,2506,4798,86,441,57,28
01428長沼町　　　　　　,4902,5361,10263,234,827,161,77
01429栗山町　　　　　　,5155,6081,11236,245,918,146,55
01430月形町　　　　　　,2174,1504,3678,64,335,45,12
01431浦臼町　　　　　　,843,881,1724,40,161,17,11
01432新十津川町　　　　,2968,3497,6465,152,519,66,35
01433妹背牛町　　　　　,1256,1394,2650,35,267,33,14
01434秩父別町　　　　　,1071,1255,2326,68,195,34,15
01436雨竜町　　　　　　,1164,1216,2380,37,216,27,7
01437北竜町　　　　　　,820,898,1718,46,180,30,6
01438沼田町　　　　　　,1387,1516,2903,68,277,38,12
01452鷹栖町　　　　　　,3102,3462,6564,154,462,66,50
01453東神楽町　　　　　,4682,5402,10084,304,566,125,91
01454当麻町　　　　　　,2906,3403,6309,133,559,62,49
01455比布町　　　　　　,1662,1855,3517,74,352,41,22
01456愛別町　　　　　　,1213,1352,2565,52,257,23,5
01457上川町　　　　　　,1688,1764,3452,67,319,48,18
01458東川町　　　　　　,3771,4277,8048,229,553,81,66
01459美瑛町　　　　　　,4459,5123,9582,201,756,142,69
01460上富良野町　　　　,5340,4945,10285,309,637,277,86
01461中富良野町　　　　,2255,2444,4699,148,379,67,29
01462南富良野町　　　　,1218,1140,2358,67,208,41,19
01463占冠村　　　　　　,572,589,1161,32,64,29,8
01464和寒町　　　　　　,1482,1688,3170,58,304,39,21
01465剣淵町　　　　　　,1425,1500,2925,72,240,30,15
01468下川町　　　　　　,1479,1621,3100,71,294,43,23
01469美深町　　　　　　,2021,2089,4110,98,353,60,21
01470音威子府村　　　　,364,341,705,23,36,15,6
01471中川町　　　　　　,798,722,1520,36,131,19,9
01472幌加内町　　　　　,680,688,1368,29,124,16,9
01481増毛町　　　　　　,1752,2076,3828,79,436,65,34
01482小平町　　　　　　,1411,1516,2927,78,282,49,15
01483苫前町　　　　　　,1418,1492,2910,67,284,35,13
01484羽幌町　　　　　　,3150,3376,6526,150,560,103,46
01485初山別村　　　　　,512,560,1072,29,70,16,7
01486遠別町　　　　　　,1201,1259,2460,46,246,42,16
01487天塩町　　　　　　,1461,1455,2916,76,225,43,23
01511猿払村　　　　　　,1250,1200,2450,113,147,56,15
01512浜頓別町　　　　　,1671,1702,3373,80,242,87,32
01513中頓別町　　　　　,816,817,1633,41,143,31,12
01514枝幸町　　　　　　,3588,3847,7435,222,629,144,69
01516豊富町　　　　　　,2086,1846,3932,103,285,65,33
01517礼文町　　　　　　,1280,1201,2481,66,178,39,15
01518利尻町　　　　　　,993,1010,2003,57,164,43,17
01519利尻富士町　　　　,1187,1260,2447,60,238,42,15
01520幌延町　　　　　　,1275,1068,2343,81,178,62,29
01543美幌町　　　　　　,9051,9558,18609,440,1335,345,144
01544津別町　　　　　　,2093,2271,4364,98,420,53,25
01545斜里町　　　　　　,5611,5620,11231,355,761,243,84
01546清里町　　　　　　,1880,2001,3881,112,318,60,23
01547小清水町　　　　　,2206,2394,4600,140,429,64,25
01549訓子府町　　　　　,2228,2421,4649,120,374,60,40
01550置戸町　　　　　　,1280,1490,2770,72,311,38,12
01552佐呂間町　　　　　,2267,2386,4653,142,428,72,35
01555遠軽町　　　　　　,9320,9852,19172,522,1564,373,148
01559湧別町　　　　　　,3913,4212,8125,211,803,116,70
01560滝上町　　　　　　,1165,1231,2396,65,241,41,11
01561興部町　　　　　　,1740,1803,3543,113,246,65,31
01562西興部村　　　　　,505,520,1025,38,121,19,7
01563雄武町　　　　　　,1932,2039,3971,109,324,64,42
01564大空町　　　　　　,3281,3481,6762,185,597,100,39
01571豊浦町　　　　　　,1749,2010,3759,84,339,43,20
01575壮瞥町　　　　　　,1276,1441,2717,63,227,29,14
01578白老町　　　　　　,7667,8355,16022,230,1506,205,113
01581厚真町　　　　　　,2209,2177,4386,134,370,73,33
01584洞爺湖町　　　　　,3871,4483,8354,168,831,102,61
01585安平町　　　　　　,3603,3664,7267,195,593,145,58
01586むかわ町　　　　　,3687,3822,7509,196,664,115,54
01601日高町　　　　　　,5509,5510,11019,276,878,199,72
01602平取町　　　　　　,2318,2331,4649,115,361,60,29
01604新冠町　　　　　　,2502,2661,5163,137,411,81,50
01607浦河町　　　　　　,5758,6060,11818,324,842,218,95
01608様似町　　　　　　,1913,2104,4017,93,382,74,26
01609えりも町　　　　　,2206,2129,4335,104,333,73,42
01610新ひだか町　　　　,10403,11010,21413,619,1596,433,184
01631音更町　　　　　　,20569,22900,43469,1303,2573,772,402
01632士幌町　　　　　　,2836,2922,5758,185,425,109,37
01633上士幌町　　　　　,2274,2368,4642,167,387,92,39
01634鹿追町　　　　　　,2551,2640,5191,173,334,89,30
01635新得町　　　　　　,2888,2896,5784,138,540,114,41
01636清水町　　　　　　,4425,4534,8959,226,658,148,56
01637芽室町　　　　　　,8583,9405,17988,514,1036,278,133
01638中札内村　　　　　,1866,1942,3808,123,218,60,25
01639更別村　　　　　　,1515,1557,3072,128,192,61,15
01641大樹町　　　　　　,2666,2646,5312,183,391,94,35
01642広尾町　　　　　　,3087,3249,6336,160,547,103,49
01643幕別町　　　　　　,12217,13440,25657,744,1700,361,209
01644池田町　　　　　　,2961,3311,6272,125,589,90,30
01645豊頃町　　　　　　,1465,1507,2972,93,255,70,18
01646本別町　　　　　　,3199,3377,6576,155,645,91,39
01647足寄町　　　　　　,3207,3330,6537,172,561,106,33
01648陸別町　　　　　　,1125,1098,2223,67,222,39,9
01649浦幌町　　　　　　,2122,2231,4353,102,391,63,28
01661釧路町　　　　　　,9039,9991,19030,640,1050,412,227
01662厚岸町　　　　　　,4143,4593,8736,205,682,147,75
01663浜中町　　　　　　,2716,2707,5423,182,398,104,45
01664標茶町　　　　　　,3454,3681,7135,198,509,114,52
01665弟子屈町　　　　　,3300,3607,6907,167,638,113,45
01667鶴居村　　　　　　,1247,1276,2523,61,156,31,22
01668白糠町　　　　　　,3405,3794,7199,129,620,104,47
01691別海町　　　　　　,7117,6864,13981,490,854,286,136
01692中標津町　　　　　,11289,11614,22903,803,1180,514,268
01693標津町　　　　　　,2427,2519,4946,169,334,86,45
01694羅臼町　　　　　　,2333,2347,4680,108,340,83,52
02青森県　　　　　　　 ,581132,651095,1232227,34308,93167,20762,9393
0231青森市保健所　　　 ,127622,146536,274158,7712,18862,4841,2053
0232八戸市保健所　　　 ,106215,116037,222252,6952,14607,4279,1798
0252弘前保健所　　　　 ,126429,148150,274579,7787,21247,4415,2026
0255五所川原保健所　　 ,55065,65132,120197,2634,11024,1491,841
0259むつ保健所　　　　 ,33266,34743,68009,1733,5737,1225,597
0262上十三保健所　　　 ,81291,85044,166335,4922,12298,3065,1366
0263東地方保健所　　　 ,9660,10653,20313,325,2207,214,95
0264三戸地方保健所　　 ,41584,44800,86384,2243,7185,1232,617
02201青森市　　　　　　,127622,146536,274158,7712,18862,4841,2053
02202弘前市　　　　　　,77008,90752,167760,4944,12487,2902,1263
02203八戸市　　　　　　,106215,116037,222252,6952,14607,4279,1798
02204黒石市　　　　　　,14759,17071,31830,875,2425,500,236
02205五所川原市　　　　,23224,28092,51316,1269,4167,733,396
02206十和田市　　　　　,28567,31478,60045,1636,4331,918,468
02207三沢市　　　　　　,19292,19178,38470,1537,2239,1087,379
02208むつ市　　　　　　,26075,27862,53937,1417,4290,960,477
02209つがる市　　　　　,14345,16531,30876,669,2784,376,213
02210平川市　　　　　　,14178,16341,30519,799,2344,396,215
02301平内町　　　　　　,4811,5268,10079,220,940,117,50
02303今別町　　　　　　,1117,1214,2331,24,352,31,9
02304蓬田村　　　　　　,1211,1327,2538,38,248,22,14
02307外ヶ浜町　　　　　,2521,2844,5365,43,667,44,22
02321鰺ケ沢町　　　　　,4140,4889,9029,144,1060,80,63
02323深浦町　　　　　　,3393,3931,7324,93,904,73,37
02343西目屋村　　　　　,589,676,1265,29,122,13,13
02361藤崎町　　　　　　,6743,7803,14546,479,1118,218,98
02362大鰐町　　　　　　,3933,4730,8663,144,926,121,53
02367田舎館村　　　　　,3423,3892,7315,221,676,102,52
02381板柳町　　　　　　,5796,6885,12681,296,1149,163,96
02384鶴田町　　　　　　,5550,6509,12059,280,1078,129,77
02387中泊町　　　　　　,4413,5180,9593,179,1031,100,55
02401野辺地町　　　　　,5732,6491,12223,228,1025,189,110
02402七戸町　　　　　　,6937,7565,14502,285,1407,199,100
02405六戸町　　　　　　,5045,5321,10366,355,757,136,79
02406横浜町　　　　　　,2063,2090,4153,86,395,66,19
02408東北町　　　　　　,7813,8512,16325,459,1471,236,118
02411六ケ所村　　　　　,5842,4409,10251,336,673,234,93
02412おいらせ町　　　　,11544,12474,24018,949,1434,484,217
02423大間町　　　　　　,2373,2336,4709,119,408,96,47
02424東通村　　　　　　,3156,2787,5943,145,567,124,58
02425風間浦村　　　　　,779,854,1633,19,230,21,9
02426佐井村　　　　　　,883,904,1787,33,242,24,6
02441三戸町　　　　　　,4281,4767,9048,182,920,105,67
02442五戸町　　　　　　,7651,8319,15970,333,1404,173,92
02443田子町　　　　　　,2375,2580,4955,99,539,61,20
02445南部町　　　　　　,7879,8897,16776,353,1725,203,97
02446階上町　　　　　　,6786,6642,13428,298,883,182,117
02450新郷村　　　　　　,1068,1121,2189,29,280,24,7
03岩手県　　　　　　　 ,580264,622939,1203203,33567,89393,20027,8227
0331盛岡市保健所　　　 ,136179,152002,288181,9601,16375,6027,2070
0351県央保健所　　　　 ,83231,89447,172678,4951,11154,2701,1241
0355奥州保健所　　　　 ,62532,65167,127699,3586,9855,2007,880
0357一関保健所　　　　 ,57514,60821,118335,2816,10326,1615,721
0359大船渡保健所　　　 ,27859,29569,57428,1313,5204,837,380
0361釜石保健所　　　　 ,20544,22261,42805,1013,4212,684,268
0362宮古保健所　　　　 ,37028,39169,76197,1911,7092,1091,449
0364久慈保健所　　　　 ,25981,28156,54137,1269,4445,743,353
0365二戸保健所　　　　 ,24058,26296,50354,1078,4782,573,279
0366中部保健所　　　　 ,105338,110051,215389,6029,15948,3749,1586
03201盛岡市　　　　　　,136179,152002,288181,9601,16375,6027,2070
03202宮古市　　　　　　,24334,25910,50244,1342,4476,755,300
03203大船渡市　　　　　,16635,17767,34402,811,3018,553,248
03205花巻市　　　　　　,44268,48536,92804,2468,7376,1509,634
03206北上市　　　　　　,46525,45739,92264,2884,5445,1877,785
03207久慈市　　　　　　,15816,16901,32717,864,2530,519,233
03208遠野市　　　　　　,12171,13040,25211,617,2487,319,148
03209一関市　　　　　　,54044,57078,111122,2655,9678,1549,683
03210陸前高田市　　　　,8796,9291,18087,404,1633,242,103
03211釜石市　　　　　　,15315,16538,31853,726,3198,510,189
03213二戸市　　　　　　,11973,13344,25317,616,2186,354,152
03214八幡平市　　　　　,11472,12454,23926,500,2242,277,128
03215奥州市　　　　　　,54585,57724,112309,3090,8777,1713,757
03216滝沢市　　　　　　,27045,28278,55323,1938,2403,1068,466
03301雫石町　　　　　　,7482,8207,15689,315,1306,188,121
03302葛巻町　　　　　　,2727,2884,5611,104,639,51,27
03303岩手町　　　　　　,5851,6269,12120,281,1221,135,65
03321紫波町　　　　　　,15353,16708,32061,937,2023,482,235
03322矢巾町　　　　　　,13301,14647,27948,876,1320,500,199
03366西和賀町　　　　　,2374,2736,5110,60,640,44,19
03381金ケ崎町　　　　　,7947,7443,15390,496,1078,294,123
03402平泉町　　　　　　,3470,3743,7213,161,648,66,38
03441住田町　　　　　　,2428,2511,4939,98,553,42,29
03461大槌町　　　　　　,5229,5723,10952,287,1014,174,79
03482山田町　　　　　　,6871,7387,14258,351,1273,201,86
03483岩泉町　　　　　　,4305,4360,8665,174,995,109,46
03484田野畑村　　　　　,1518,1512,3030,44,348,26,17
03485普代村　　　　　　,1233,1233,2466,53,249,34,17
03501軽米町　　　　　　,4087,4245,8332,160,849,81,51
03503野田村　　　　　　,1853,2061,3914,110,329,33,20
03506九戸村　　　　　　,2554,2808,5362,92,513,45,15
03507洋野町　　　　　　,7079,7961,15040,242,1337,157,83
03524一戸町　　　　　　,5444,5899,11343,210,1234,93,61
04宮城県　　　　　　　 ,1112335,1167868,2280203,72251,128291,46348,17252
0406仙台市保健所　　　 ,524458,558732,1083190,38372,47861,26184,8134
0451石巻保健所　　　　 ,127319,132562,259881,7224,19062,4477,1942
0452塩釜保健所　　　　 ,216834,223853,440687,14498,22812,8215,3461
0453大崎保健所　　　　 ,126162,132259,258421,6607,20191,3978,2025
0454気仙沼保健所　　　 ,35716,36902,72618,1510,6081,1018,499
0456仙南保健所　　　　 ,81846,83560,165406,4040,12284,2476,1191
04100仙台市　　　　　　,524458,558732,1083190,38372,47861,26184,8134
04101仙台市青葉区　　　,147383,157674,305057,9279,13741,6797,2080
04102仙台市宮城野区　　,95210,99292,194502,8125,7818,5926,1732
04103仙台市若林区　　　,68850,71154,140004,5551,5993,4144,1074
04104仙台市太白区　　　,111912,120897,232809,9079,11054,5238,1772
04105仙台市泉区　　　　,101103,109715,210818,6338,9255,4079,1476
04202石巻市　　　　　　,67931,71079,139010,3793,10042,2497,1076
04203塩竈市　　　　　　,24750,26935,51685,1296,3672,820,397
04205気仙沼市　　　　　,29757,30800,60557,1228,5068,843,422
04206白石市　　　　　　,15893,16647,32540,687,2524,433,220
04207名取市　　　　　　,38384,39935,78319,2930,3397,1582,665
04208角田市　　　　　　,13698,14065,27763,618,2359,367,213
04209多賀城市　　　　　,31206,31223,62429,2515,2821,1548,542
04211岩沼市　　　　　　,21514,22167,43681,1558,2150,867,310
04212登米市　　　　　　,37054,38643,75697,1992,6154,1081,502
04213栗原市　　　　　　,30998,33153,64151,1341,6115,773,423
04214東松島市　　　　　,19034,19922,38956,1252,2319,784,325
04215大崎市　　　　　　,62137,64431,126568,3755,8573,2364,1107
04216富谷市　　　　　　,24980,26444,51424,1657,1649,718,382
04301蔵王町　　　　　　,5527,5824,11351,269,1027,143,93
04302七ケ宿町　　　　　,609,626,1235,19,191,16,7
04321大河原町　　　　　,11452,11992,23444,754,1384,446,200
04322村田町　　　　　　,5269,5343,10612,229,834,154,61
04323柴田町　　　　　　,19272,18846,38118,1102,2124,696,278
04324川崎町　　　　　　,4082,4132,8214,159,616,94,48
04341丸森町　　　　　　,6044,6085,12129,203,1225,127,71
04361亘理町　　　　　　,16144,16786,32930,918,2033,537,250
04362山元町　　　　　　,5948,6040,11988,251,968,146,82
04401松島町　　　　　　,6384,6876,13260,266,1125,180,80
04404七ケ浜町　　　　　,8971,9063,18034,421,1073,267,125
04406利府町　　　　　　,17101,17955,35056,1245,1373,660,264
04421大和町　　　　　　,14785,13571,28356,1100,1424,724,268
04422大郷町　　　　　　,3769,3965,7734,160,685,88,44
04424大衡村　　　　　　,2898,2893,5791,181,442,78,52
04444色麻町　　　　　　,3242,3422,6664,173,539,81,63
04445加美町　　　　　　,10691,11088,21779,464,1892,264,159
04501涌谷町　　　　　　,7499,7831,15330,324,1217,191,119
04505美里町　　　　　　,11595,12334,23929,550,1855,305,154
04581女川町　　　　　　,3300,2918,6218,187,547,115,39
04606南三陸町　　　　　,5959,6102,12061,282,1013,175,77
05秋田県　　　　　　　 ,451082,504577,955659,22562,79872,13964,5848
0531秋田市保健所　　　 ,144717,161629,306346,8783,19317,5694,2087
0552大館保健所　　　　 ,48373,54295,102668,2351,9560,1417,636
0553北秋田保健所　　　 ,15122,16976,32098,500,3442,358,147
0554能代保健所　　　　 ,34364,40003,74367,1409,7623,868,448
0557秋田中央保健所　　 ,36889,41483,78372,1513,7179,931,412
0558由利本荘保健所　　 ,46913,50872,97785,2257,8147,1250,577
0561大仙保健所　　　　 ,56304,64207,120511,2698,11341,1682,741
0562横手保健所　　　　 ,40252,44922,85174,1944,7452,1098,498
0563湯沢保健所　　　　 ,28148,30190,58338,1107,5811,666,302
05201秋田市　　　　　　,144717,161629,306346,8783,19317,5694,2087
05202能代市　　　　　　,22894,26866,49760,1050,4825,652,317
05203横手市　　　　　　,40252,44922,85174,1944,7452,1098,498
05204大館市　　　　　　,32493,36431,68924,1620,6276,975,467
05206男鹿市　　　　　　,11839,13271,25110,341,2807,256,113
05207湯沢市　　　　　　,20089,21888,41977,774,4154,487,211
05209鹿角市　　　　　　,13656,15341,28997,651,2753,391,145
05210由利本荘市　　　　,35742,38692,74434,1795,6148,979,436
05211潟上市　　　　　　,14924,16709,31633,786,2336,453,197
05212大仙市　　　　　　,36213,41213,77426,1896,7180,1173,502
05213北秋田市　　　　　,14139,15917,30056,473,3125,340,141
05214にかほ市　　　　　,11171,12180,23351,462,1999,271,141
05215仙北市　　　　　　,11394,13127,24521,419,2469,290,147
05303小坂町　　　　　　,2224,2523,4747,80,531,51,24
05327上小阿仁村　　　　,983,1059,2042,27,317,18,6
05346藤里町　　　　　　,1377,1493,2870,32,401,31,18
05348三種町　　　　　　,7024,8184,15208,230,1667,140,71
05349八峰町　　　　　　,3069,3460,6529,97,730,45,42
05361五城目町　　　　　,3984,4536,8520,141,929,77,39
05363八郎潟町　　　　　,2525,3032,5557,102,493,56,27
05366井川町　　　　　　,2127,2433,4560,75,410,49,20
05368大潟村　　　　　　,1490,1502,2992,68,204,40,16
05434美郷町　　　　　　,8697,9867,18564,383,1692,219,92
05463羽後町　　　　　　,6626,7097,13723,283,1407,160,82
05464東成瀬村　　　　　,1433,1205,2638,50,250,19,9
06山形県　　　　　　　 ,513878,546708,1060586,31163,79023,18153,6719
0631山形市保健所　　　 ,118449,127835,246284,8343,14794,4891,1584
0653村山保健所　　　　 ,137634,144454,282088,8547,21207,4795,1718
0654最上保健所　　　　 ,33916,36307,70223,1753,6462,1016,495
0661置賜保健所　　　　 ,98317,101692,200009,5465,15521,3329,1324
0662庄内保健所　　　　 ,125562,136420,261982,7055,21039,4122,1598
06201山形市　　　　　　,118449,127835,246284,8343,14794,4891,1584
06202米沢市　　　　　　,39946,40569,80515,2258,5637,1434,529
06203鶴岡市　　　　　　,58413,63225,121638,3441,9582,1912,789
06204酒田市　　　　　　,47708,52053,99761,2549,7964,1597,602
06205新庄市　　　　　　,16373,17669,34042,987,2672,609,245
06206寒河江市　　　　　,19419,20413,39832,1399,2775,742,243
06207上山市　　　　　　,13867,15092,28959,637,2446,379,145
06208村山市　　　　　　,10908,11428,22336,479,2036,276,115
06209長井市　　　　　　,12818,13384,26202,745,2141,435,181
06210天童市　　　　　　,29952,31657,61609,2291,3717,1233,449
06211東根市　　　　　　,23427,23924,47351,1993,2859,1172,332
06212尾花沢市　　　　　,7313,7578,14891,288,1443,193,98
06213南陽市　　　　　　,14552,15598,30150,931,2307,579,219
06301山辺町　　　　　　,6590,7088,13678,327,1056,169,60
06302中山町　　　　　　,5227,5462,10689,258,796,139,57
06321河北町　　　　　　,8458,8999,17457,423,1365,204,110
06322西川町　　　　　　,2382,2532,4914,80,566,44,13
06323朝日町　　　　　　,3139,3175,6314,131,680,80,21
06324大江町　　　　　　,3744,3815,7559,129,825,83,40
06341大石田町　　　　　,3208,3291,6499,112,643,81,35
06361金山町　　　　　　,2464,2550,5014,116,484,62,38
06362最上町　　　　　　,3909,4089,7998,170,762,92,52
06363舟形町　　　　　　,2420,2554,4974,101,548,66,26
06364真室川町　　　　　,3390,3778,7168,146,841,65,48
06365大蔵村　　　　　　,1497,1515,3012,63,326,21,21
06366鮭川村　　　　　　,1885,1991,3876,86,371,52,34
06367戸沢村　　　　　　,1978,2161,4139,84,458,49,31
06381高畠町　　　　　　,10863,11404,22267,620,1687,355,170
06382川西町　　　　　　,7089,7401,14490,352,1237,191,79
06401小国町　　　　　　,3534,3517,7051,128,659,95,36
06402白鷹町　　　　　　,6314,6455,12769,257,1186,152,74
06403飯豊町　　　　　　,3201,3364,6565,174,667,88,36
06426三川町　　　　　　,3682,3889,7571,288,592,132,49
06428庄内町　　　　　　,9602,10443,20045,498,1636,332,110
06461遊佐町　　　　　　,6157,6810,12967,279,1265,149,48
07福島県　　　　　　　 ,897843,921242,1819085,55620,127219,34303,14301
0731郡山市保健所　　　 ,160487,164341,324828,11347,17683,7284,2909
0732いわき市保健所　　 ,162248,167868,330116,9757,21818,6231,2822
0733福島市保健所　　　 ,137383,143328,280711,8617,17217,5382,1948
0770南会津保健所　　　 ,11914,12236,24150,476,2511,310,146
0771県北保健所　　　　 ,89205,92803,182008,4802,14006,2685,1191
0772県中保健所　　　　 ,94044,96429,190473,5347,13763,3039,1294
0773県南保健所　　　　 ,68623,68741,137364,4204,9154,2557,1071
0774会津保健所　　　　 ,110769,119948,230717,6778,19035,3858,1636
0775相双保健所　　　　 ,63170,55548,118718,4292,12032,2957,1284
07201福島市　　　　　　,137383,143328,280711,8617,17217,5382,1948
07202会津若松市　　　　,55716,60802,116518,3797,8039,2161,907
07203郡山市　　　　　　,160487,164341,324828,11347,17683,7284,2909
07204いわき市　　　　　,162248,167868,330116,9757,21818,6231,2822
07205白河市　　　　　　,29428,29433,58861,1849,3510,1170,462
07207須賀川市　　　　　,36615,37974,74589,2497,4486,1382,543
07208喜多方市　　　　　,21373,23171,44544,1300,4144,738,314
07209相馬市　　　　　　,17474,17198,34672,1079,2334,673,288
07210二本松市　　　　　,26166,27044,53210,1502,3960,864,361
07211田村市　　　　　　,17212,17639,34851,834,3019,500,203
07212南相馬市　　　　　,30825,27734,58559,1455,4417,1095,442
07213伊達市　　　　　　,28171,29659,57830,1376,4620,739,331
07214本宮市　　　　　　,14942,15108,30050,947,1850,551,234
07301桑折町　　　　　　,5482,5942,11424,271,1089,136,73
07303国見町　　　　　　,4105,4475,8580,127,689,71,53
07308川俣町　　　　　　,5941,6120,12061,203,1275,145,65
07322大玉村　　　　　　,4398,4455,8853,376,523,179,74
07342鏡石町　　　　　　,6012,6256,12268,421,712,250,108
07344天栄村　　　　　　,2533,2605,5138,137,521,81,42
07362下郷町　　　　　　,2600,2649,5249,84,589,50,35
07364檜枝岐村　　　　　,259,245,504,14,27,7,2
07367只見町　　　　　　,1962,2052,4014,97,444,43,18
07368南会津町　　　　　,7093,7290,14383,281,1451,210,91
07402北塩原村　　　　　,1277,1244,2521,54,207,35,23
07405西会津町　　　　　,2782,2950,5732,123,710,69,37
07407磐梯町　　　　　　,1599,1714,3313,101,248,49,15
07408猪苗代町　　　　　,6508,6980,13488,311,1218,201,74
07421会津坂下町　　　　,7190,7751,14941,401,1308,225,105
07422湯川村　　　　　　,1485,1588,3073,94,236,30,18
07423柳津町　　　　　　,1500,1574,3074,64,357,38,16
07444三島町　　　　　　,711,733,1444,22,204,20,6
07445金山町　　　　　　,904,947,1851,26,320,19,1
07446昭和村　　　　　　,623,619,1242,25,198,17,6
07447会津美里町　　　　,9101,9875,18976,460,1846,256,114
07461西郷村　　　　　　,10504,10043,20547,762,1217,452,175
07464泉崎村　　　　　　,3020,3075,6095,168,415,80,48
07465中島村　　　　　　,2368,2482,4850,136,348,63,35
07466矢吹町　　　　　　,8559,8565,17124,545,1138,340,136
07481棚倉町　　　　　　,6547,6725,13272,371,1015,227,106
07482矢祭町　　　　　　,2613,2756,5369,124,547,66,40
07483塙町　　　　　　　,4053,4162,8215,184,659,124,49
07484鮫川村　　　　　　,1531,1500,3031,65,305,35,20
07501石川町　　　　　　,7296,7237,14533,316,1148,213,98
07502玉川村　　　　　　,3156,3165,6321,191,461,89,43
07503平田村　　　　　　,2817,2889,5706,109,455,85,43
07504浅川町　　　　　　,3027,2985,6012,139,499,81,38
07505古殿町　　　　　　,2356,2411,4767,90,454,43,19
07521三春町　　　　　　,8430,8530,16960,415,1183,199,96
07522小野町　　　　　　,4590,4738,9328,198,825,116,61
07541広野町　　　　　　,3256,2081,5337,111,317,79,24
07542楢葉町　　　　　　,2133,1555,3688,177,494,128,66
07543富岡町　　　　　　,1539,579,2118,257,784,190,97
07544川内村　　　　　　,1032,978,2010,35,274,52,16
07545大熊町　　　　　　,753,93,846,292,558,159,75
07546双葉町　　　　　　,-,-,0,135,417,88,42
07547浪江町　　　　　　,1347,571,1918,364,1273,276,117
07548葛尾村　　　　　　,238,178,416,37,132,28,15
07561新地町　　　　　　,3912,3943,7855,250,587,124,68
07564飯舘村　　　　　　,661,638,1299,100,445,65,34
08茨城県　　　　　　　 ,1397039,1404601,2801640,87168,170368,55408,21777
0831水戸市保健所　　　 ,130929,136090,267019,10097,14753,6458,2214
0855日立保健所　　　　 ,120601,121105,241706,6204,16209,4210,1573
0857潮来保健所　　　　 ,132945,127691,260636,8264,16685,5455,2287
0858竜ケ崎保健所　　　 ,223941,226865,450806,12713,25161,7905,3422
0859土浦保健所　　　　 ,124056,124554,248610,7225,16288,5026,2155
0862筑西保健所　　　　 ,122432,123343,245775,6575,16889,4134,1947
0865古河保健所　　　　 ,108759,108348,217107,6382,13529,4147,1772
0869つくば保健所　　　 ,168720,168892,337612,14376,15462,8462,2661
0870ひたちなか保健所　 ,173911,174749,348660,10385,22035,6450,2335
0871中央保健所　　　　 ,90745,92964,183709,4947,13357,3161,1411
08201水戸市　　　　　　,130929,136090,267019,10097,14753,6458,2214
08202日立市　　　　　　,86331,86450,172781,4483,11136,3157,1068
08203土浦市　　　　　　,68677,68962,137639,4260,8308,3148,1272
08204古河市　　　　　　,67913,68120,136033,4209,8045,2786,1157
08205石岡市　　　　　　,35610,36304,71914,1956,5204,1224,579
08207結城市　　　　　　,24127,24310,48437,1314,3213,868,362
08208龍ケ崎市　　　　　,36859,37397,74256,1844,4007,1223,611
08210下妻市　　　　　　,20245,20155,40400,1209,2568,793,369
08211常総市　　　　　　,27809,28029,55838,1384,3762,971,440
08212常陸太田市　　　　,23621,24801,48422,1014,4072,561,278
08214高萩市　　　　　　,13669,13819,27488,671,2000,410,191
08215北茨城市　　　　　,20601,20836,41437,1050,3073,643,314
08216笠間市　　　　　　,35409,37020,72429,2071,5004,1248,519
08217取手市　　　　　　,50823,52197,103020,2728,6333,1734,750
08219牛久市　　　　　　,41098,42094,83192,2493,3880,1489,640
08220つくば市　　　　　,116258,116166,232424,10905,9185,6415,1800
08221ひたちなか市　　　,78376,76374,154750,5359,7640,3501,1168
08222鹿嶋市　　　　　　,34031,31960,65991,2149,3860,1401,585
08223潮来市　　　　　　,13484,13753,27237,682,1830,457,201
08224守谷市　　　　　　,33685,33568,67253,2723,2329,1466,437
08225常陸大宮市　　　　,19277,19733,39010,871,3300,502,231
08226那珂市　　　　　　,25896,27334,53230,1581,3330,922,339
08227筑西市　　　　　　,48756,49415,98171,2726,6545,1724,825
08228坂東市　　　　　　,25132,24697,49829,1340,3388,857,379
08229稲敷市　　　　　　,18915,19058,37973,707,3147,536,306
08230かすみがうら市　　,19769,19288,39057,1009,2776,654,304
08231桜川市　　　　　　,19214,19614,38828,781,3126,473,244
08232神栖市　　　　　　,48174,44584,92758,3634,4626,2472,967
08233行方市　　　　　　,15482,15772,31254,717,2864,406,199
08234鉾田市　　　　　　,21774,21622,43396,1082,3505,719,335
08235つくばみらい市　　,24653,24697,49350,2087,2515,1076,421
08236小美玉市　　　　　,23773,23657,47430,1478,3222,986,422
08302茨城町　　　　　　,15242,15603,30845,779,2278,495,234
08309大洗町　　　　　　,7427,7547,14974,295,1263,193,133
08310城里町　　　　　　,8894,9137,18031,324,1590,239,103
08341東海村　　　　　　,19072,18522,37594,1310,1814,790,232
08364大子町　　　　　　,7669,7985,15654,250,1879,174,87
08442美浦村　　　　　　,7345,6946,14291,371,969,293,139
08443阿見町　　　　　　,23844,23753,47597,1516,2667,924,385
08447河内町　　　　　　,4007,4117,8124,146,741,91,65
08521八千代町　　　　　,10090,9849,19939,545,1437,276,147
08542五霞町　　　　　　,3986,3962,7948,134,586,84,36
08546境町　　　　　　　,11728,11569,23297,699,1510,420,200
08564利根町　　　　　　,7365,7735,15100,185,1088,149,89
09栃木県　　　　　　　 ,943800,947596,1891396,59904,113429,38431,14767
0931宇都宮市保健所　　 ,255373,253756,509129,18997,24971,12761,4057
0962県西保健所　　　　 ,83301,86051,169352,4561,12247,2827,1328
0963県東保健所　　　　 ,67644,66558,134202,3963,8763,2341,1017
0964県南保健所　　　　 ,231727,232205,463932,14892,26698,9176,3542
0965県北保健所　　　　 ,181038,180398,361436,10612,22733,6677,2820
0966安足保健所　　　　 ,124717,128628,253345,6879,18017,4649,2003
09201宇都宮市　　　　　,255373,253756,509129,18997,24971,12761,4057
09202足利市　　　　　　,68720,71287,140007,3501,10172,2519,1122
09203栃木市　　　　　　,74927,76421,151348,4183,10462,2594,1069
09204佐野市　　　　　　,55997,57341,113338,3378,7845,2130,881
09205鹿沼市　　　　　　,45848,46771,92619,2731,6174,1644,746
09206日光市　　　　　　,37453,39280,76733,1830,6073,1183,582
09208小山市　　　　　　,80727,79131,159858,5752,8267,3610,1378
09209真岡市　　　　　　,37864,36953,74817,2549,4357,1525,621
09210大田原市　　　　　,34854,36079,70933,2094,4317,1273,500
09211矢板市　　　　　　,15299,15560,30859,720,2063,475,243
09213那須塩原市　　　　,56236,56761,112997,3722,6159,2287,1064
09214さくら市　　　　　,22899,21233,44132,1614,2352,954,338
09215那須烏山市　　　　,12273,12375,24648,500,2211,307,131
09216下野市　　　　　　,29141,29648,58789,2076,2925,1274,378
09301上三川町　　　　　,15607,14813,30420,1085,1467,597,255
09342益子町　　　　　　,10794,10906,21700,481,1467,318,158
09343茂木町　　　　　　,5841,5956,11797,179,1173,122,48
09344市貝町　　　　　　,5667,5422,11089,293,723,182,79
09345芳賀町　　　　　　,7478,7321,14799,461,1043,194,111
09361壬生町　　　　　　,19109,19820,38929,1099,2168,676,300
09364野木町　　　　　　,12216,12372,24588,697,1409,425,162
09384塩谷町　　　　　　,5120,5181,10301,165,925,123,92
09386高根沢町　　　　　,15037,13766,28803,1093,1513,781,191
09407那須町　　　　　　,11692,12000,23692,437,1849,285,164
09411那珂川町　　　　　,7628,7443,15071,267,1344,192,97
10群馬県　　　　　　　 ,928834,950986,1879820,58407,120370,36861,14579
1031前橋市保健所　　　 ,158443,166453,324896,10897,19897,6819,2497
1032高崎市保健所　　　 ,180079,187135,367214,12726,21328,7870,2900
1054伊勢崎保健所　　　 ,116600,117238,233838,8464,12769,5584,2120
1056渋川保健所　　　　 ,53711,55774,109485,3401,7459,2059,781
1057藤岡保健所　　　　 ,31790,33431,65221,1619,4458,1030,447
1058富岡保健所　　　　 ,33124,33992,67116,1451,5720,875,370
1060吾妻保健所　　　　 ,25045,25475,50520,1105,4429,709,328
1061利根沼田保健所　　 ,36668,38989,75657,1831,6165,1152,510
1062館林保健所　　　　 ,84621,82173,166794,4480,10206,3018,1255
1064桐生保健所　　　　 ,74830,78844,153674,3683,11777,2366,1098
1065太田保健所　　　　 ,107280,103729,211009,7541,11790,4624,1900
1066安中保健所　　　　 ,26643,27753,54396,1209,4372,755,373
10201前橋市　　　　　　,158443,166453,324896,10897,19897,6819,2497
10202高崎市　　　　　　,180079,187135,367214,12726,21328,7870,2900
10203桐生市　　　　　　,50635,54113,104748,2158,8720,1454,712
10204伊勢崎市　　　　　,99494,99275,198769,7303,11095,4839,1847
10205太田市　　　　　　,107280,103729,211009,7541,11790,4624,1900
10206沼田市　　　　　　,21659,23094,44753,1112,3411,751,339
10207館林市　　　　　　,36391,36282,72673,1878,4496,1337,525
10208渋川市　　　　　　,36053,37750,73803,1853,5759,1216,467
10209藤岡市　　　　　　,30427,32049,62476,1575,4074,997,435
10210富岡市　　　　　　,23068,23567,46635,1061,3638,625,282
10211安中市　　　　　　,26643,27753,54396,1209,4372,755,373
10212みどり市　　　　　,24195,24731,48926,1525,3057,912,386
10344榛東村　　　　　　,7108,6939,14047,494,733,307,118
10345吉岡町　　　　　　,10550,11085,21635,1054,967,536,196
10366上野村　　　　　　,573,538,1111,31,119,16,5
10367神流町　　　　　　,790,844,1634,13,265,17,7
10382下仁田町　　　　　,3216,3329,6545,72,841,70,25
10383南牧村　　　　　　,759,847,1606,11,275,18,2
10384甘楽町　　　　　　,6081,6249,12330,307,966,162,61
10421中之条町　　　　　,7413,7777,15190,355,1362,197,92
10424長野原町　　　　　,2497,2539,5036,116,414,87,41
10425嬬恋村　　　　　　,4410,4296,8706,237,694,151,54
10426草津町　　　　　　,2929,2853,5782,101,499,100,42
10428高山村　　　　　　,1620,1698,3318,91,300,52,28
10429東吾妻町　　　　　,6176,6312,12488,205,1160,122,71
10443片品村　　　　　　,1921,2030,3951,80,370,56,17
10444川場村　　　　　　,1589,1881,3470,69,247,40,20
10448昭和村　　　　　　,3266,3251,6517,203,506,86,46
10449みなかみ町　　　　,8233,8733,16966,367,1631,219,88
10464玉村町　　　　　　,17106,17963,35069,1161,1674,745,273
10521板倉町　　　　　　,6897,6893,13790,209,1045,125,76
10522明和町　　　　　　,5336,5270,10606,293,670,167,79
10523千代田町　　　　　,5320,5202,10522,279,685,174,93
10524大泉町　　　　　　,18195,16157,34352,1190,1773,844,319
10525邑楽町　　　　　　,12482,12369,24851,631,1537,371,163
11埼玉県　　　　　　　 ,3559650,3599437,7159087,235742,365406,152844,55327
1101さいたま市保健所　 ,640115,656982,1297097,49636,58379,31635,9241
1132川越市保健所　　　 ,172725,173062,345787,11327,17507,7257,2647
1133越谷市保健所　　　 ,165555,169459,335014,12116,15680,7688,2710
1134川口市保健所　　　 ,280428,276895,557323,19785,28536,14450,5214
1155朝霞保健所　　　　 ,353667,358734,712401,26552,31842,16401,5452
1156鴻巣保健所　　　　 ,257893,263076,520969,15845,26795,9955,3866
1161東松山保健所　　　 ,102430,101523,203953,5244,12397,3178,1347
1162秩父保健所　　　　 ,46016,47886,93902,2242,7611,1273,606
1163本庄保健所　　　　 ,64351,64697,129048,3615,8824,2204,1023
1164熊谷保健所　　　　 ,179877,181255,361132,10648,22292,6705,2636
1168加須保健所　　　　 ,118092,119634,237726,6191,14521,3903,1930
1169春日部保健所　　　 ,125729,128506,254235,6841,14097,4635,2084
1171幸手保健所　　　　 ,191931,194220,386151,10691,21530,6544,2668
1174坂戸保健所　　　　 ,111716,113526,225242,5586,12177,3817,1752
1175草加保健所　　　　 ,271700,266630,538330,19157,24819,13046,4751
1176狭山保健所　　　　 ,375406,383910,759316,22044,39959,14023,5658
1177南部保健所　　　　 ,102019,99442,201461,8222,8440,6130,1742
11100さいたま市　　　　,640115,656982,1297097,49636,58379,31635,9241
11101さいたま市西区　　,45343,47113,92456,3917,4754,2121,745
11102さいたま市北区　　,72121,74184,146305,5271,6304,3696,1015
11103さいたま市大宮区　,57034,57893,114927,4600,5389,3470,822
11104さいたま市見沼区　,79281,82687,161968,5152,8231,3107,1268
11105さいたま市中央区　,50128,51242,101370,3937,4094,2896,602
11106さいたま市桜区　　,48418,47503,95921,2954,4166,2150,733
11107さいたま市浦和区　,78067,83524,161591,6740,6326,4150,917
11108さいたま市南区　　,92907,93465,186372,8515,6997,5405,1308
11109さいたま市緑区　　,62342,64181,126523,5285,5497,2766,954
11110さいたま市岩槻区　,54474,55190,109664,3265,6621,1874,877
11201川越市　　　　　　,172725,173062,345787,11327,17507,7257,2647
11202熊谷市　　　　　　,95454,95600,191054,5585,11660,3753,1393
11203川口市　　　　　　,280428,276895,557323,19785,28536,14450,5214
11206行田市　　　　　　,37956,39110,77066,1904,4981,1276,675
11207秩父市　　　　　　,28873,30264,59137,1565,4573,861,402
11208所沢市　　　　　　,165352,171339,336691,10708,16653,7020,2522
11209飯能市　　　　　　,39791,39568,79359,2073,4592,1152,528
11210加須市　　　　　　,54770,54575,109345,2913,6299,1751,857
11211本庄市　　　　　　,37892,38083,75975,2264,4858,1385,620
11212東松山市　　　　　,44678,44364,89042,2724,4663,1718,603
11214春日部市　　　　　,111682,114614,226296,6238,12565,4229,1815
11215狭山市　　　　　　,72929,73092,146021,4070,8199,2727,1087
11216羽生市　　　　　　,25366,25949,51315,1374,3241,876,398
11217鴻巣市　　　　　　,56747,58258,115005,3313,6031,1984,781
11218深谷市　　　　　　,68607,69610,138217,4262,8372,2471,992
11219上尾市　　　　　　,110399,112626,223025,7281,11161,4567,1716
11221草加市　　　　　　,121736,119420,241156,7617,11273,5477,2010
11222越谷市　　　　　　,165555,169459,335014,12116,15680,7688,2710
11223蕨市　　　　　　　,34140,33630,67770,2259,3581,2049,515
11224戸田市　　　　　　,67879,65812,133691,5963,4859,4081,1227
11225入間市　　　　　　,70712,72763,143475,3938,7409,2348,1100
11227朝霞市　　　　　　,68786,68503,137289,6205,5311,3943,999
11228志木市　　　　　　,36104,37434,73538,2904,3373,1655,581
11229和光市　　　　　　,41952,39811,81763,3676,2675,2770,653
11230新座市　　　　　　,80032,82346,162378,5295,7665,3020,1266
11231桶川市　　　　　　,36505,37411,73916,2123,3999,1377,524
11232久喜市　　　　　　,73224,74341,147565,4063,8072,2413,977
11233北本市　　　　　　,31961,32678,64639,1711,3764,1129,446
11234八潮市　　　　　　,45968,43458,89426,3770,3850,2902,883
11235富士見市　　　　　,53638,55456,109094,3958,5243,2442,902
11237三郷市　　　　　　,68958,68375,137333,5061,6714,3035,1256
11238蓮田市　　　　　　,30163,30727,60890,1770,3391,1191,415
11239坂戸市　　　　　　,48544,48817,97361,2592,5056,1713,841
11240幸手市　　　　　　,24443,24575,49018,977,3055,651,373
11241鶴ケ島市　　　　　,33927,34804,68731,2070,3359,1350,509
11242日高市　　　　　　,26622,27148,53770,1255,3106,776,421
11243吉川市　　　　　　,35038,35377,70415,2709,2982,1632,602
11245ふじみ野市　　　　,54580,56079,110659,3531,5607,2084,804
11246白岡市　　　　　　,25487,26166,51653,1892,2656,1081,352
11301伊奈町　　　　　　,22281,22103,44384,1417,1840,898,399
11324三芳町　　　　　　,18575,19105,37680,983,1968,487,247
11326毛呂山町　　　　　,17298,17521,34819,543,2044,458,239
11327越生町　　　　　　,5442,5462,10904,193,757,163,81
11341滑川町　　　　　　,9793,9429,19222,813,827,288,152
11342嵐山町　　　　　　,8643,8652,17295,359,1164,269,116
11343小川町　　　　　　,14042,14209,28251,455,2167,308,151
11346川島町　　　　　　,9661,9381,19042,367,1218,233,128
11347吉見町　　　　　　,9051,8986,18037,330,1213,228,126
11348鳩山町　　　　　　,6505,6922,13427,188,961,133,82
11349ときがわ町　　　　,5212,5152,10364,161,880,111,64
11361横瀬町　　　　　　,3950,3966,7916,215,694,114,48
11362皆野町　　　　　　,4552,4686,9238,199,793,114,52
11363長瀞町　　　　　　,3308,3475,6783,103,602,69,38
11365小鹿野町　　　　　,5333,5495,10828,160,949,115,66
11369東秩父村　　　　　,1350,1350,2700,35,265,23,7
11381美里町　　　　　　,5448,5454,10902,271,979,163,68
11383神川町　　　　　　,6550,6418,12968,262,1150,161,89
11385上里町　　　　　　,14461,14742,29203,818,1837,495,246
11408寄居町　　　　　　,15816,16045,31861,801,2260,481,251
11442宮代町　　　　　　,16963,16766,33729,1049,1908,625,226
11464杉戸町　　　　　　,21651,21645,43296,940,2448,583,325
11465松伏町　　　　　　,14047,13892,27939,603,1532,406,269
12千葉県　　　　　　　 ,3039216,3082989,6122205,199763,321185,130905,47125
1201千葉市保健所　　　 ,467453,479116,946569,30274,47875,20457,7332
1232船橋市保健所　　　 ,309409,314420,623829,21966,28481,15351,4428
1233柏市保健所　　　　 ,206125,210725,416850,15048,19331,8795,3332
1252市川保健所　　　　 ,323539,322015,645554,24950,24464,19173,4791
1253松戸保健所　　　　 ,398393,407773,806166,29987,39049,18244,5987
1254野田保健所　　　　 ,74408,74740,149148,3896,8552,2546,1343
1255印旛保健所　　　　 ,345360,352010,697370,21344,34528,12454,5719
1260長生保健所　　　　 ,69805,71892,141697,3359,10591,2260,1123
1261夷隅保健所　　　　 ,33306,34190,67496,1137,6443,771,431
1262市原保健所　　　　 ,135711,127855,263566,7897,14943,5350,2266
1263君津保健所　　　　 ,162079,157997,320076,10456,19294,6637,2729
1269習志野保健所　　　 ,233947,240006,473953,16814,21800,10247,3512
1270香取保健所　　　　 ,51213,52212,103425,2195,8485,1420,650
1271海匝保健所　　　　 ,74853,78342,153195,3475,12379,2392,1081
1272山武保健所　　　　 ,96571,97965,194536,4412,13852,3046,1653
1273安房保健所　　　　 ,57044,61731,118775,2553,11118,1762,748
12100千葉市　　　　　　,467453,479116,946569,30274,47875,20457,7332
12101千葉市中央区　　　,102843,102279,205122,7658,10410,6403,1771
12102千葉市花見川区　　,84846,87753,172599,5168,9219,3670,1259
12103千葉市稲毛区　　　,78173,78073,156246,4777,7850,3138,1129
12104千葉市若葉区　　　,71154,71971,143125,4252,8978,2945,1295
12105千葉市緑区　　　　,62379,65511,127890,4668,5636,2433,976
12106千葉市美浜区　　　,68058,73529,141587,3751,5782,1868,902
12202銚子市　　　　　　,27125,29088,56213,874,5178,723,370
12203市川市　　　　　　,242076,236249,478325,19098,19544,14938,3573
12204船橋市　　　　　　,309409,314420,623829,21966,28481,15351,4428
12205館山市　　　　　　,21761,23038,44799,1117,3759,782,342
12206木更津市　　　　　,67360,66282,133642,4779,7311,3112,1286
12207松戸市　　　　　　,238782,241958,480740,16125,24103,10937,3781
12208野田市　　　　　　,74408,74740,149148,3896,8552,2546,1343
12210茂原市　　　　　　,42139,43312,85451,2214,5909,1511,704
12211成田市　　　　　　,63147,63773,126920,4333,5785,3043,1071
12212佐倉市　　　　　　,80880,84536,165416,4161,9015,2671,1208
12213東金市　　　　　　,28456,28123,56579,1433,3462,1060,562
12215旭市　　　　　　　,30641,31708,62349,1871,4369,1168,482
12216習志野市　　　　　,85787,85922,171709,6390,7210,3885,1134
12217柏市　　　　　　　,206125,210725,416850,15048,19331,8795,3332
12218勝浦市　　　　　　,8613,8148,16761,247,1579,183,111
12219市原市　　　　　　,135711,127855,263566,7897,14943,5350,2266
12220流山市　　　　　　,96897,99813,196710,10248,7978,5048,1341
12221八千代市　　　　　,95342,98653,193995,7024,9057,4082,1579
12222我孫子市　　　　　,62714,66002,128716,3614,6968,2259,865
12223鴨川市　　　　　　,15027,16552,31579,834,2870,537,193
12224鎌ケ谷市　　　　　,52818,55431,108249,3400,5533,2280,799
12225君津市　　　　　　,41623,39755,81378,2365,5153,1587,649
12226富津市　　　　　　,21248,20698,41946,747,3605,601,301
12227浦安市　　　　　　,81463,85766,167229,5852,4920,4235,1218
12228四街道市　　　　　,44998,46224,91222,3340,4450,1686,768
12229袖ケ浦市　　　　　,31848,31262,63110,2565,3225,1337,493
12230八街市　　　　　　,32956,32145,65101,1397,4050,1051,697
12231印西市　　　　　　,49642,50886,100528,4300,3943,1333,702
12232白井市　　　　　　,30227,31002,61229,1664,2708,841,484
12233富里市　　　　　　,23782,23064,46846,1367,2383,1217,513
12234南房総市　　　　　,16916,18551,35467,508,3708,372,173
12235匝瑳市　　　　　　,17087,17546,34633,730,2832,501,229
12236香取市　　　　　　,35246,36193,71439,1543,5736,1004,422
12237山武市　　　　　　,23704,23796,47500,967,3705,650,370
12238いすみ市　　　　　,17185,17916,35101,691,3180,438,243
12239大網白里市　　　　,23322,24192,47514,1194,3007,751,389
12322酒々井町　　　　　,9949,10279,20228,434,984,344,119
12329栄町　　　　　　　,9779,10101,19880,348,1210,268,157
12342神崎町　　　　　　,2860,2825,5685,127,489,82,36
12347多古町　　　　　　,6699,6614,13313,266,1117,181,98
12349東庄町　　　　　　,6408,6580,12988,259,1143,153,94
12403九十九里町　　　　,7055,7283,14338,200,1339,197,102
12409芝山町　　　　　　,3397,3450,6847,118,526,91,66
12410横芝光町　　　　　,10637,11121,21758,500,1813,297,164
12421一宮町　　　　　　,5775,5993,11768,315,892,209,93
12422睦沢町　　　　　　,3248,3470,6718,152,570,66,44
12423長生村　　　　　　,6772,6943,13715,247,967,194,106
12424白子町　　　　　　,5081,5141,10222,200,936,127,89
12426長柄町　　　　　　,3269,3382,6651,105,552,75,46
12427長南町　　　　　　,3521,3651,7172,126,765,78,41
12441大多喜町　　　　　,4261,4532,8793,116,917,75,50
12443御宿町　　　　　　,3247,3594,6841,83,767,75,27
12463鋸南町　　　　　　,3340,3590,6930,94,781,71,40
13東京都　　　　　　　 ,6623630,6860398,13484028,495130,628255,387698,105056
1327世田谷保健所　　　 ,433841,486679,920520,33852,35600,27612,6535
1331渋谷区保健所　　　 ,111889,121110,232999,9621,8301,9627,2105
1337池袋保健所　　　　 ,137290,136749,274039,9496,12379,10229,2152
1342荒川区保健所　　　 ,99114,100534,199648,7913,10717,6727,1695
1348足立保健所　　　　 ,331550,329264,660814,21939,37901,17561,6112
1350葛飾区保健所　　　 ,216217,216734,432951,15519,24539,11159,3755
1352江戸川保健所　　　 ,333203,327646,660849,24945,31142,17041,6068
1354台東保健所　　　　 ,101397,95721,197118,7636,10150,9122,1748
1355目黒区保健所　　　 ,130733,147768,278501,11388,10710,11061,2365
1356大田区保健所　　　 ,357559,358951,716510,26629,34260,22864,5361
1357杉並保健所　　　　 ,275548,297919,573467,21332,23861,17773,3597
1358北区保健所　　　　 ,166155,168683,334838,13026,18810,10929,2389
1359板橋区保健所　　　 ,270121,280661,550782,19333,27104,16076,4343
1360みなと保健所　　　 ,113176,127906,241082,13049,8203,9886,2658
1361中野区保健所　　　 ,163057,163135,326192,11963,14307,12800,2608
1362新宿区保健所　　　 ,155373,155455,310828,11696,13912,12566,2693
1363品川区保健所　　　 ,201761,206623,408384,18170,16367,15417,3161
1364千代田保健所　　　 ,32181,31764,63945,3041,2084,3053,610
1365練馬区保健所　　　 ,352097,379595,731692,26985,32633,18810,5326
1366文京保健所　　　　 ,110277,118895,229172,9782,8447,7600,1430
1367墨田区保健所　　　 ,130152,131123,261275,11439,12847,11909,2353
1368江東区保健所　　　 ,243913,250397,494310,20134,21298,14951,4184
1369中央区保健所　　　 ,77311,84480,161791,10004,4793,8166,1760
1371多摩府中保健所　　 ,506930,532936,1039866,38353,43790,25551,6669
1372西多摩保健所　　　 ,184702,185413,370115,9741,24944,6472,3212
1373八王子市保健所　　 ,284733,281095,565828,14883,28541,9699,4311
1375町田市保健所　　　 ,207067,216839,423906,12024,21077,7008,2980
1385島しょ保健所　　　 ,12793,11414,24207,765,2011,499,218
1391南多摩保健所　　　 ,209509,213056,422565,13874,18727,8080,2809
1392多摩立川保健所　　 ,317810,325915,643725,22425,31620,14128,4896
1397多摩小平保健所　　 ,356171,375938,732109,24173,37180,13322,4953
13100東京都の区部　　　,4543915,4717792,9261707,358892,420365,302939,75008
13101千代田区　　　　　,32181,31764,63945,3041,2084,3053,610
13102中央区　　　　　　,77311,84480,161791,10004,4793,8166,1760
13103港区　　　　　　　,113176,127906,241082,13049,8203,9886,2658
13104新宿区　　　　　　,155373,155455,310828,11696,13912,12566,2693
13105文京区　　　　　　,110277,118895,229172,9782,8447,7600,1430
13106台東区　　　　　　,101397,95721,197118,7636,10150,9122,1748
13107墨田区　　　　　　,130152,131123,261275,11439,12847,11909,2353
13108江東区　　　　　　,243913,250397,494310,20134,21298,14951,4184
13109品川区　　　　　　,201761,206623,408384,18170,16367,15417,3161
13110目黒区　　　　　　,130733,147768,278501,11388,10710,11061,2365
13111大田区　　　　　　,357559,358951,716510,26629,34260,22864,5361
13112世田谷区　　　　　,433841,486679,920520,33852,35600,27612,6535
13113渋谷区　　　　　　,111889,121110,232999,9621,8301,9627,2105
13114中野区　　　　　　,163057,163135,326192,11963,14307,12800,2608
13115杉並区　　　　　　,275548,297919,573467,21332,23861,17773,3597
13116豊島区　　　　　　,137290,136749,274039,9496,12379,10229,2152
13117北区　　　　　　　,166155,168683,334838,13026,18810,10929,2389
13118荒川区　　　　　　,99114,100534,199648,7913,10717,6727,1695
13119板橋区　　　　　　,270121,280661,550782,19333,27104,16076,4343
13120練馬区　　　　　　,352097,379595,731692,26985,32633,18810,5326
13121足立区　　　　　　,331550,329264,660814,21939,37901,17561,6112
13122葛飾区　　　　　　,216217,216734,432951,15519,24539,11159,3755
13123江戸川区　　　　　,333203,327646,660849,24945,31142,17041,6068
13201八王子市　　　　　,284733,281095,565828,14883,28541,9699,4311
13202立川市　　　　　　,89220,90129,179349,6321,9011,4305,1426
13203武蔵野市　　　　　,70221,76586,146807,5648,6131,4289,870
13204三鷹市　　　　　　,92539,98949,191488,6865,8052,4582,1117
13205青梅市　　　　　　,65810,65809,131619,3060,8991,2092,1071
13206府中市　　　　　　,128806,128415,257221,8900,11201,5680,1798
13207昭島市　　　　　　,55248,55752,111000,3929,6069,2419,915
13208調布市　　　　　　,114736,123152,237888,8920,9719,5932,1581
13209町田市　　　　　　,207067,216839,423906,12024,21077,7008,2980
13210小金井市　　　　　,60324,62840,123164,4893,4804,3180,781
13211小平市　　　　　　,94925,98431,193356,6994,8678,3675,1209
13212日野市　　　　　　,92844,93459,186303,6520,8360,4015,1250
13213東村山市　　　　　,72366,76388,148754,4606,8298,2587,1136
13214国分寺市　　　　　,61536,64603,126139,4774,5191,2958,723
13215国立市　　　　　　,36704,38647,75351,2370,3455,1629,516
13218福生市　　　　　　,26199,26459,52658,1643,3204,1464,542
13219狛江市　　　　　　,40304,42994,83298,3127,3883,1888,522
13220東大和市　　　　　,40603,42197,82800,2768,4278,1618,692
13221清瀬市　　　　　　,35928,38939,74867,2181,4449,1282,522
13222東久留米市　　　　,54620,58409,113029,3568,6396,1913,748
13223武蔵村山市　　　　,34499,34587,69086,2263,3616,1199,624
13224多摩市　　　　　　,70521,74034,144555,3884,6969,2188,949
13225稲城市　　　　　　,46144,45563,91707,3470,3398,1877,610
13227羽村市　　　　　　,26813,26148,52961,1549,2773,992,474
13228あきる野市　　　　,38697,39561,78258,2182,4964,1201,672
13229西東京市　　　　　,98332,103771,202103,6824,9359,3865,1338
13303瑞穂町　　　　　　,15595,15444,31039,763,1972,473,302
13305日の出町　　　　　,8238,8642,16880,422,1759,192,127
13307檜原村　　　　　　,982,1016,1998,49,419,17,11
13308奥多摩町　　　　　,2368,2334,4702,73,862,41,13
13361大島町　　　　　　,3596,3420,7016,183,682,120,65
13362利島村　　　　　　,194,128,322,11,19,10,4
13363新島村　　　　　　,1200,1230,2430,68,229,38,14
13364神津島村　　　　　,948,902,1850,60,132,41,16
13381三宅村　　　　　　,1260,982,2242,80,242,57,13
13382御蔵島村　　　　　,172,141,313,11,13,5,-
13401八丈町　　　　　　,3528,3431,6959,225,634,120,74
13402青ケ島村　　　　　,102,67,169,7,5,5,1
13421小笠原村　　　　　,1793,1113,2906,120,55,103,31
14神奈川県　　　　　　 ,4474645,4531963,9006608,305798,439427,209497,69308
1402相模原市保健所　　 ,353091,354086,707177,22743,34577,14988,5728
1403川崎市保健所　　　 ,753282,738954,1492236,62061,60195,46865,11111
1429横浜市保健所　　　 ,1816951,1856949,3673900,124682,175435,85013,27626
1441横須賀市保健所　　 ,191078,191814,382892,10149,25047,6961,3139
1443藤沢市保健所　　　 ,211998,218228,430226,15877,19640,9749,3441
1444茅ケ崎市保健所　　 ,140662,147189,287851,9534,13772,5691,2281
1451平塚保健所　　　　 ,285477,284319,569796,15995,30561,10356,4245
1452鎌倉保健所　　　　 ,141494,159425,300919,7753,19195,4931,2125
1454小田原保健所　　　 ,161023,170959,331982,8825,21675,5907,2456
1457厚木保健所　　　　 ,419589,410040,829629,28179,39330,19036,7156
14100横浜市　　　　　　,1816951,1856949,3673900,124682,175435,85013,27626
14101横浜市鶴見区　　　,146469,136913,283382,10446,12677,7392,2420
14102横浜市神奈川区　　,122215,117418,239633,8853,10621,7179,1818
14103横浜市西区　　　　,50605,49456,100061,3772,4464,3605,820
14104横浜市中区　　　　,69388,65408,134796,3787,8160,3920,1417
14105横浜市南区　　　　,94030,93466,187496,5261,11214,4680,1795
14106横浜市保土ケ谷区　,99071,102928,201999,6059,11046,4242,1444
14107横浜市磯子区　　　,79654,82019,161673,5296,8736,3255,1211
14108横浜市金沢区　　　,95476,100299,195775,5187,10165,3153,1280
14109横浜市港北区　　　,175463,175809,351272,15680,12958,11768,2396
14110横浜市戸塚区　　　,136014,143188,279202,10255,12933,5555,1975
14111横浜市港南区　　　,103590,108703,212293,6475,10885,4294,1496
14112横浜市旭区　　　　,116723,125291,242014,7280,14056,4434,1799
14113横浜市緑区　　　　,88118,90768,178886,6389,8078,3953,1289
14114横浜市瀬谷区　　　,58447,62254,120701,3752,6915,2402,1019
14115横浜市栄区　　　　,58014,61006,119020,3713,6328,2193,805
14116横浜市泉区　　　　,72821,77186,150007,4934,8007,2928,1043
14117横浜市青葉区　　　,148033,158137,306170,10041,11414,5945,2090
14118横浜市都筑区　　　,102820,106700,209520,7502,6778,4115,1509
14130川崎市　　　　　　,753282,738954,1492236,62061,60195,46865,11111
14131川崎市川崎区　　　,117130,99128,216258,7237,12101,6614,2073
14132川崎市幸区　　　　,84305,81463,165768,7886,7589,5164,1209
14133川崎市中原区　　　,130778,126686,257464,13194,8251,11000,1772
14134川崎市高津区　　　,113562,115205,228767,9833,8251,7453,1719
14135川崎市多摩区　　　,110360,106219,216579,8920,8159,7917,1570
14136川崎市宮前区　　　,111365,118417,229782,8883,8644,5001,1739
14137川崎市麻生区　　　,85782,91836,177618,6108,7200,3716,1029
14150相模原市　　　　　,353091,354086,707177,22743,34577,14988,5728
14151相模原市緑区　　　,83569,82614,166183,4822,8643,3183,1378
14152相模原市中央区　　,133682,133123,266805,8684,12892,5538,2360
14153相模原市南区　　　,135840,138349,274189,9237,13042,6267,1990
14201横須賀市　　　　　,191078,191814,382892,10149,25047,6961,3139
14203平塚市　　　　　　,126711,126489,253200,7380,13775,4793,2009
14204鎌倉市　　　　　　,80319,90901,171220,4653,10238,3106,1180
14205藤沢市　　　　　　,211998,218228,430226,15877,19640,9749,3441
14206小田原市　　　　　,90222,96078,186300,5460,11662,3636,1416
14207茅ヶ崎市　　　　　,116655,123769,240424,7950,11420,4694,1823
14208逗子市　　　　　　,26433,30087,56520,1650,3522,964,410
14210三浦市　　　　　　,19980,21781,41761,758,3518,499,294
14211秦野市　　　　　　,80128,78543,158671,3989,8165,2604,1175
14212厚木市　　　　　　,111173,104697,215870,6534,10294,4475,1898
14213大和市　　　　　　,116006,115879,231885,9039,10764,6347,2091
14214伊勢原市　　　　　,50088,48957,99045,3266,4824,2211,691
14215海老名市　　　　　,67214,66577,133791,5149,5672,3272,974
14216座間市　　　　　　,64185,64329,128514,4097,6116,2758,1115
14217南足柄市　　　　　,19823,20625,40448,919,2501,663,297
14218綾瀬市　　　　　　,40207,39466,79673,2464,4077,1522,702
14301葉山町　　　　　　,14762,16656,31418,692,1917,362,241
14321寒川町　　　　　　,24007,23420,47427,1584,2352,997,458
14341大磯町　　　　　　,15342,16151,31493,758,2039,401,202
14342二宮町　　　　　　,13208,14179,27387,602,1758,347,168
14361中井町　　　　　　,4489,4481,8970,154,572,105,47
14362大井町　　　　　　,8373,8632,17005,517,840,333,149
14363松田町　　　　　　,5377,5379,10756,288,747,175,91
14364山北町　　　　　　,4789,4899,9688,151,854,91,51
14366開成町　　　　　　,8837,9335,18172,693,769,341,137
14382箱根町　　　　　　,5234,5617,10851,149,944,165,74
14383真鶴町　　　　　　,3103,3562,6665,96,623,83,37
14384湯河原町　　　　　,10776,12351,23127,398,2163,315,157
14401愛川町　　　　　　,19256,17624,36880,831,2216,623,362
14402清川村　　　　　　,1548,1468,3016,65,191,39,14
15新潟県　　　　　　　 ,1062137,1123034,2185171,65470,153398,38835,13306
1501新潟市保健所　　　 ,377095,406838,783933,26011,46952,15777,5002
1551新発田保健所　　　 ,86129,90918,177047,5340,12878,2927,1130
1552新津保健所　　　　 ,27612,29469,57081,1198,5111,744,305
1554三条保健所　　　　 ,104348,110616,214964,6028,15273,3494,1208
1557長岡保健所　　　　 ,167961,173853,341814,10533,23350,6226,2002
1559魚沼保健所　　　　 ,16719,17539,34258,914,2758,503,201
1560南魚沼保健所　　　 ,30470,31317,61787,1796,4581,950,413
1561十日町保健所　　　 ,28612,29814,58426,1435,5073,771,319
1562柏崎保健所　　　　 ,42430,42593,85023,2303,6519,1427,525
1566糸魚川保健所　　　 ,19918,20474,40392,943,3648,548,221
1567村上保健所　　　　 ,30002,32577,62579,1395,5748,874,350
1568佐渡保健所　　　　 ,24840,26451,51291,1197,5861,682,335
1569上越保健所　　　　 ,106001,110575,216576,6377,15646,3912,1295
15100新潟市　　　　　　,377095,406838,783933,26011,46952,15777,5002
15101新潟市北区　　　　,35218,37079,72297,2053,4539,1149,452
15102新潟市東区　　　　,63961,69611,133572,4809,7834,3049,969
15103新潟市中央区　　　,85134,93349,178483,6373,9885,4399,1108
15104新潟市江南区　　　,32743,34869,67612,2411,4175,1342,467
15105新潟市秋葉区　　　,35931,38874,74805,2404,4824,1223,438
15106新潟市南区　　　　,20916,22348,43264,1340,2949,822,295
15107新潟市西区　　　　,77091,82509,159600,5244,8869,2898,979
15108新潟市西蒲区　　　,26101,28199,54300,1377,3877,895,294
15202長岡市　　　　　　,130210,134595,264805,8330,17742,4993,1572
15204三条市　　　　　　,45455,48573,94028,2765,6624,1533,531
15205柏崎市　　　　　　,40192,40465,80657,2174,6256,1363,503
15206新発田市　　　　　,45741,48576,94317,2919,6829,1688,614
15208小千谷市　　　　　,16790,17129,33919,969,2456,530,198
15209加茂市　　　　　　,12370,12981,25351,556,2189,319,125
15210十日町市　　　　　,24301,25239,49540,1207,4138,666,275
15211見附市　　　　　　,18987,20004,38991,1161,2637,658,215
15212村上市　　　　　　,27382,29724,57106,1299,5129,798,320
15213燕市　　　　　　　,37418,39294,76712,2339,5083,1416,448
15216糸魚川市　　　　　,19918,20474,40392,943,3648,548,221
15217妙高市　　　　　　,14671,15446,30117,700,2619,428,148
15218五泉市　　　　　　,22794,24358,47152,1051,3876,633,271
15222上越市　　　　　　,91330,95129,186459,5677,13027,3484,1147
15223阿賀野市　　　　　,19491,20958,40449,1086,3089,552,216
15224佐渡市　　　　　　,24840,26451,51291,1197,5861,682,335
15225魚沼市　　　　　　,16719,17539,34258,914,2758,503,201
15226南魚沼市　　　　　,26570,27564,54134,1612,3968,837,346
15227胎内市　　　　　　,13853,14458,28311,707,2178,404,170
15307聖籠町　　　　　　,7044,6926,13970,628,782,283,130
15342弥彦村　　　　　　,3727,3958,7685,168,542,92,50
15361田上町　　　　　　,5378,5810,11188,200,835,134,54
15385阿賀町　　　　　　,4818,5111,9929,147,1235,111,34
15405出雲崎町　　　　　,1974,2125,4099,73,515,45,17
15461湯沢町　　　　　　,3900,3753,7653,184,613,113,67
15482津南町　　　　　　,4311,4575,8886,228,935,105,44
15504刈羽村　　　　　　,2238,2128,4366,129,263,64,22
15581関川村　　　　　　,2439,2683,5122,86,584,66,27
15586粟島浦村　　　　　,181,170,351,10,35,10,3
16富山県　　　　　　　 ,494151,523170,1017321,31804,67956,19224,6126
1631富山市保健所　　　 ,198891,208103,406994,14042,24496,8873,2730
1653高岡保健所　　　　 ,142394,152442,294836,8918,20643,5211,1709
1661新川保健所　　　　 ,55251,58504,113755,3082,8350,1926,622
1662中部保健所　　　　 ,38126,40625,78751,2317,5418,1286,487
1663砺波保健所　　　　 ,59489,63496,122985,3445,9049,1928,578
16201富山市　　　　　　,198891,208103,406994,14042,24496,8873,2730
16202高岡市　　　　　　,78750,84303,163053,5050,11303,3093,946
16204魚津市　　　　　　,19548,20562,40110,1150,2971,794,235
16205氷見市　　　　　　,20717,22808,43525,978,3859,606,225
16206滑川市　　　　　　,15554,16398,31952,1114,1934,637,222
16207黒部市　　　　　　,19340,19982,39322,1235,2495,709,236
16208砺波市　　　　　　,23071,24344,47415,1439,2927,833,245
16209小矢部市　　　　　,13782,14673,28455,772,2148,429,132
16210南砺市　　　　　　,22636,24479,47115,1234,3974,666,201
16211射水市　　　　　　,42927,45331,88258,2890,5481,1512,538
16321舟橋村　　　　　　,1494,1587,3081,143,145,46,16
16322上市町　　　　　　,9160,9974,19134,394,1543,235,105
16323立山町　　　　　　,11918,12666,24584,666,1796,368,144
16342入善町　　　　　　,11174,12192,23366,510,1852,308,102
16343朝日町　　　　　　,5189,5768,10957,187,1032,115,49
17石川県　　　　　　　 ,541717,575647,1117364,38212,65874,22714,7110
1734金沢市保健所　　　 ,221746,235804,457550,16540,23636,10670,2977
1762南加賀保健所　　　 ,106512,112874,219386,7581,13284,4351,1414
1763石川中央保健所　　 ,129043,134053,263096,10282,12317,5316,1845
1764能登中部保健所　　 ,55818,60838,116656,2667,9752,1659,617
1765能登北部保健所　　 ,28598,32078,60676,1142,6885,718,257
17201金沢市　　　　　　,221746,235804,457550,16540,23636,10670,2977
17202七尾市　　　　　　,23770,25848,49618,1161,4063,738,290
17203小松市　　　　　　,50636,53034,103670,3941,5895,2266,693
17204輪島市　　　　　　,11638,12796,24434,462,2697,299,119
17205珠洲市　　　　　　,5911,6943,12854,230,1480,141,43
17206加賀市　　　　　　,29515,32776,62291,1709,4764,1073,384
17207羽咋市　　　　　　,9621,10641,20262,479,1712,314,93
17209かほく市　　　　　,16670,17917,34587,1466,1933,645,230
17210白山市　　　　　　,52684,56245,108929,3951,5521,1844,707
17211能美市　　　　　　,23375,23978,47353,1695,2371,933,314
17212野々市市　　　　　,29245,27435,56680,2852,1878,1746,470
17324川北町　　　　　　,2986,3086,6072,236,254,79,23
17361津幡町　　　　　　,17882,18789,36671,1230,1785,693,263
17365内灘町　　　　　　,12562,13667,26229,783,1200,388,175
17384志賀町　　　　　　,8836,9631,18467,346,1715,239,99
17386宝達志水町　　　　,5666,6282,11948,241,994,168,59
17407中能登町　　　　　,7925,8436,16361,440,1268,200,76
17461穴水町　　　　　　,3747,4060,7807,145,900,89,37
17463能登町　　　　　　,7302,8279,15581,305,1808,189,58
18福井県　　　　　　　 ,367290,384728,752018,26530,48340,15259,5094
1831福井市保健所　　　 ,125945,131957,257902,9783,15275,5802,1921
1851福井保健所　　　　 ,9129,9596,18725,530,1185,300,110
1852坂井保健所　　　　 ,54872,59138,114010,3643,6959,2134,682
1857二州保健所　　　　 ,42692,43744,86436,2997,5844,1776,665
1858若狭保健所　　　　 ,23554,23155,46709,1783,3384,946,280
1859奥越保健所　　　　 ,25369,27319,52688,1433,4398,817,280
1860丹南保健所　　　　 ,85729,89819,175548,6361,11295,3484,1156
18201福井市　　　　　　,125945,131957,257902,9783,15275,5802,1921
18202敦賀市　　　　　　,31449,31961,63410,2227,3897,1344,545
18204小浜市　　　　　　,14216,14475,28691,1074,2118,548,173
18205大野市　　　　　　,14852,15965,30817,844,2614,459,177
18206勝山市　　　　　　,10517,11354,21871,589,1784,358,103
18207鯖江市　　　　　　,32949,34482,67431,2723,3623,1385,482
18208あわら市　　　　　,12861,14189,27050,760,1974,458,136
18209越前市　　　　　　,37200,38620,75820,2730,4905,1528,507
18210坂井市　　　　　　,42011,44949,86960,2883,4985,1676,546
18322永平寺町　　　　　,9129,9596,18725,530,1185,300,110
18382池田町　　　　　　,1183,1226,2409,53,270,52,8
18404南越前町　　　　　,4781,5164,9945,279,835,165,37
18423越前町　　　　　　,9616,10327,19943,576,1662,354,122
18442美浜町　　　　　　,4591,4517,9108,326,775,206,44
18481高浜町　　　　　　,5376,4802,10178,369,692,201,64
18483おおい町　　　　　,3962,3878,7840,340,574,197,43
18501若狭町　　　　　　,6652,7266,13918,444,1172,226,76
19山梨県　　　　　　　 ,390141,404217,794358,25658,50992,16168,6222
1931甲府市保健所　　　 ,90235,93819,184054,6230,11747,4396,1547
1954峡南保健所　　　　 ,23104,24197,47301,971,4643,672,300
1959中北保健所　　　　 ,130747,133526,264273,9403,14461,5526,2204
1960峡東保健所　　　　 ,62096,66145,128241,3958,9136,2392,1008
1961富士・東部保健所　 ,83959,86530,170489,5096,11005,3182,1163
19201甲府市　　　　　　,90235,93819,184054,6230,11747,4396,1547
19202富士吉田市　　　　,22429,23597,46026,1609,2927,912,327
19204都留市　　　　　　,14676,15794,30470,849,1875,492,220
19205山梨市　　　　　　,16012,17233,33245,935,2509,537,217
19206大月市　　　　　　,10842,11496,22338,347,1985,285,127
19207韮崎市　　　　　　,14279,14296,28575,762,1711,518,229
19208南アルプス市　　　,33703,34748,68451,2436,3867,1313,544
19209北杜市　　　　　　,21290,22256,43546,963,3404,654,295
19210甲斐市　　　　　　,36741,37469,74210,3285,3301,1851,739
19211笛吹市　　　　　　,32071,33856,65927,2337,4272,1440,587
19212上野原市　　　　　,11130,11211,22341,381,1719,265,107
19213甲州市　　　　　　,14013,15056,29069,686,2355,415,204
19214中央市　　　　　　,14600,14748,29348,940,1435,627,235
19346市川三郷町　　　　,7053,7426,14479,343,1278,183,87
19364早川町　　　　　　,624,467,1091,9,133,21,8
19365身延町　　　　　　,5168,5399,10567,127,1359,133,57
19366南部町　　　　　　,3457,3640,7097,109,730,98,39
19368富士川町　　　　　,6802,7265,14067,383,1143,237,109
19384昭和町　　　　　　,10134,10009,20143,1017,743,563,162
19422道志村　　　　　　,806,792,1598,30,113,28,15
19423西桂町　　　　　　,1934,2078,4012,107,222,55,34
19424忍野村　　　　　　,5012,3972,8984,452,361,423,67
19425山中湖村　　　　　,2490,2568,5058,173,261,100,38
19429鳴沢村　　　　　　,1380,1423,2803,97,211,48,14
19430富士河口湖町　　　,12649,13005,25654,1030,1215,551,213
19442小菅村　　　　　　,339,337,676,13,53,11,1
19443丹波山村　　　　　,272,257,529,8,63,12,-
20長野県　　　　　　　 ,985058,1028481,2013539,65258,131395,39882,14170
2031長野市保健所　　　 ,179537,189320,368857,12661,21989,7735,2352
2032松本市保健所　　　 ,116572,120519,237091,8459,13422,5587,1864
2051佐久保健所　　　　 ,98132,101876,200008,6721,13283,3982,1541
2053上田保健所　　　　 ,92929,96813,189742,6145,12506,3811,1362
2054諏訪保健所　　　　 ,93545,96823,190368,5958,12276,3659,1438
2056伊那保健所　　　　 ,86445,89220,175665,5709,11138,3350,1198
2057飯田保健所　　　　 ,73811,78685,152496,5178,11403,2860,1075
2058木曽保健所　　　　 ,12253,12905,25158,494,2529,346,113
2059松本保健所　　　　 ,88149,91570,179719,5811,11215,3657,1333
2061大町保健所　　　　 ,26908,28180,55088,1377,3991,962,406
2066長野保健所　　　　 ,76991,80826,157817,4505,11242,2664,984
2068北信保健所　　　　 ,39786,41744,81530,2240,6401,1269,504
20201長野市　　　　　　,179537,189320,368857,12661,21989,7735,2352
20202松本市　　　　　　,116572,120519,237091,8459,13422,5587,1864
20203上田市　　　　　　,73636,76806,150442,4947,9850,3119,1104
20204岡谷市　　　　　　,22896,24164,47060,1457,3219,926,346
20205飯田市　　　　　　,46436,49608,96044,3445,6753,1963,689
20206諏訪市　　　　　　,23275,24272,47547,1664,2907,1081,391
20207須坂市　　　　　　,24053,24851,48904,1546,3150,873,329
20208小諸市　　　　　　,19732,20502,40234,1363,2637,814,370
20209伊那市　　　　　　,31717,32752,64469,2072,4108,1284,487
20210駒ケ根市　　　　　,15473,16133,31606,1058,2163,632,207
20211中野市　　　　　　,20421,21334,41755,1302,2699,707,286
20212大町市　　　　　　,12472,13054,25526,657,1906,460,180
20213飯山市　　　　　　,9425,9920,19345,490,1619,262,90
20214茅野市　　　　　　,27746,27670,55416,1766,3096,1037,419
20215塩尻市　　　　　　,32992,32927,65919,2368,3872,1624,515
20217佐久市　　　　　　,47550,49385,96935,3541,6138,2012,706
20218千曲市　　　　　　,28098,29929,58027,1753,4026,1028,367
20219東御市　　　　　　,14576,15081,29657,957,1782,557,212
20220安曇野市　　　　　,44948,48053,93001,2844,5666,1700,661
20303小海町　　　　　　,2088,2197,4285,115,408,63,19
20304川上村　　　　　　,1815,1704,3519,145,251,69,20
20305南牧村　　　　　　,1382,1406,2788,97,258,49,16
20306南相木村　　　　　,463,478,941,15,83,11,9
20307北相木村　　　　　,347,371,718,15,69,11,10
20309佐久穂町　　　　　,4944,5204,10148,241,882,174,48
20321軽井沢町　　　　　,8976,9805,18781,521,1131,326,162
20323御代田町　　　　　,7574,7580,15154,504,865,342,130
20324立科町　　　　　　,3261,3244,6505,164,561,111,51
20349青木村　　　　　　,1958,2133,4091,122,364,64,23
20350長和町　　　　　　,2759,2793,5552,119,510,71,23
20361下諏訪町　　　　　,9156,9761,18917,486,1532,279,133
20362富士見町　　　　　,6740,7124,13864,358,1010,221,93
20363原村　　　　　　　,3732,3832,7564,227,512,115,56
20382辰野町　　　　　　,8861,9324,18185,432,1411,288,107
20383箕輪町　　　　　　,12169,12067,24236,787,1346,464,155
20384飯島町　　　　　　,4286,4495,8781,247,695,135,56
20385南箕輪村　　　　　,7723,7787,15510,710,705,362,105
20386中川村　　　　　　,2175,2413,4588,136,274,59,29
20388宮田村　　　　　　,4041,4249,8290,267,436,126,52
20402松川町　　　　　　,6007,6409,12416,382,846,220,87
20403高森町　　　　　　,6088,6561,12649,408,821,200,96
20404阿南町　　　　　　,2062,2196,4258,86,554,49,18
20407阿智村　　　　　　,2843,3098,5941,193,530,79,45
20409平谷村　　　　　　,189,195,384,4,39,3,4
20410根羽村　　　　　　,410,427,837,20,107,9,3
20411下條村　　　　　　,1702,1807,3509,119,280,59,25
20412売木村　　　　　　,246,295,541,8,47,8,5
20413天龍村　　　　　　,552,615,1167,22,213,14,4
20414泰阜村　　　　　　,716,800,1516,55,199,23,6
20415喬木村　　　　　　,2887,3029,5916,196,472,91,29
20416豊丘村　　　　　　,3141,3166,6307,218,421,124,59
20417大鹿村　　　　　　,532,479,1011,22,121,18,5
20422上松町　　　　　　,2034,2042,4076,57,444,54,21
20423南木曽町　　　　　,1886,2000,3886,74,399,53,19
20425木祖村　　　　　　,1231,1437,2668,56,297,28,10
20429王滝村　　　　　　,337,365,702,16,70,9,3
20430大桑村　　　　　　,1637,1726,3363,93,322,50,11
20432木曽町　　　　　　,5128,5335,10463,198,997,152,49
20446麻績村　　　　　　,1214,1361,2575,57,361,29,16
20448生坂村　　　　　　,818,810,1628,54,139,26,12
20450山形村　　　　　　,4046,4191,8237,273,503,133,72
20451朝日村　　　　　　,2096,2142,4238,138,290,83,37
20452筑北村　　　　　　,2035,2086,4121,77,384,62,20
20481池田町　　　　　　,4486,4776,9262,176,836,120,70
20482松川村　　　　　　,4557,4908,9465,257,542,171,74
20485白馬村　　　　　　,4061,4188,8249,215,501,179,62
20486小谷村　　　　　　,1332,1254,2586,72,206,32,20
20521坂城町　　　　　　,6679,6943,13622,324,1073,200,90
20541小布施町　　　　　,5109,5504,10613,334,673,160,48
20543高山村　　　　　　,3176,3343,6519,125,536,97,28
20561山ノ内町　　　　　,5480,5704,11184,228,1038,183,75
20562木島平村　　　　　,2110,2244,4354,88,482,54,29
20563野沢温泉村　　　　,1553,1694,3247,104,318,45,14
20583信濃町　　　　　　,3786,3894,7680,157,700,108,39
20588小川村　　　　　　,1093,1106,2199,47,264,31,10
20590飯綱町　　　　　　,4997,5256,10253,219,820,167,73
20602栄村　　　　　　　,797,848,1645,28,245,18,10
21岐阜県　　　　　　　 ,934429,990252,1924681,61442,119500,36256,13857
2134岐阜市保健所　　　 ,188221,205958,394179,13436,23691,8344,2967
2156関保健所　　　　　 ,68510,71926,140436,3983,10144,2262,908
2159東濃保健所　　　　 ,94216,100379,194595,5629,12522,3352,1355
2160恵那保健所　　　　 ,59180,62387,121567,3456,8911,2023,812
2163岐阜保健所　　　　 ,187024,194544,381568,13798,19794,8101,3061
2164西濃保健所　　　　 ,169963,178952,348915,10262,21881,6142,2443
2165可茂保健所　　　　 ,101317,104536,205853,6664,12085,3819,1466
2166飛騨保健所　　　　 ,65998,71570,137568,4214,10472,2213,845
21201岐阜市　　　　　　,188221,205958,394179,13436,23691,8344,2967
21202大垣市　　　　　　,74305,78665,152970,5640,8816,3398,1195
21203高山市　　　　　　,40179,43531,83710,2874,5770,1505,568
21204多治見市　　　　　,50562,54205,104767,3064,6175,1884,744
21205関市　　　　　　　,40635,42545,83180,2452,5276,1479,604
21206中津川市　　　　　,36460,38203,74663,2241,5243,1312,512
21207美濃市　　　　　　,9069,9688,18757,471,1496,240,108
21208瑞浪市　　　　　　,17655,18522,36177,1132,2447,654,246
21209羽島市　　　　　　,31701,32791,64492,1972,3505,1189,557
21210恵那市　　　　　　,22720,24184,46904,1215,3668,711,300
21211美濃加茂市　　　　,25485,26052,51537,1959,2589,1045,386
21212土岐市　　　　　　,25999,27652,53651,1433,3900,814,365
21213各務原市　　　　　,69537,71784,141321,4831,7353,2870,1028
21214可児市　　　　　　,45266,46676,91942,2999,4685,1827,681
21215山県市　　　　　　,12006,12677,24683,539,1745,321,143
21216瑞穂市　　　　　　,26891,27071,53962,2597,2116,1515,479
21217飛騨市　　　　　　,10808,11607,22415,537,1868,282,118
21218本巣市　　　　　　,15652,16659,32311,866,1958,452,229
21219郡上市　　　　　　,18806,19693,38499,1060,3372,543,196
21220下呂市　　　　　　,14265,15696,29961,739,2723,398,153
21221海津市　　　　　　,15707,16333,32040,638,2190,418,192
21302岐南町　　　　　　,12389,12865,25254,1452,1072,858,279
21303笠松町　　　　　　,10389,11453,21842,872,1257,495,190
21341養老町　　　　　　,12870,13564,26434,519,1877,356,157
21361垂井町　　　　　　,12571,13037,25608,696,1678,396,169
21362関ケ原町　　　　　,3136,3335,6471,104,566,77,33
21381神戸町　　　　　　,8944,9276,18220,495,1102,323,127
21382輪之内町　　　　　,4513,4677,9190,299,472,158,63
21383安八町　　　　　　,6898,7170,14068,373,810,217,119
21401揖斐川町　　　　　,9238,10069,19307,394,1786,233,96
21403大野町　　　　　　,10637,11133,21770,560,1223,283,141
21404池田町　　　　　　,11144,11693,22837,544,1361,283,151
21421北方町　　　　　　,8459,9244,17703,669,788,401,156
21501坂祝町　　　　　　,3847,3692,7539,293,400,163,65
21502富加町　　　　　　,2631,2860,5491,221,322,95,33
21503川辺町　　　　　　,4748,4912,9660,287,644,147,65
21504七宗町　　　　　　,1607,1768,3375,66,403,47,21
21505八百津町　　　　　,4860,5195,10055,194,922,122,52
21506白川町　　　　　　,3439,3869,7308,114,837,81,35
21507東白川村　　　　　,952,1044,1996,44,192,30,10
21521御嵩町　　　　　　,8482,8468,16950,487,1091,262,118
21604白川村　　　　　　,746,736,1482,64,111,28,6
22静岡県　　　　　　　 ,1745786,1795148,3540934,113292,216881,71930,27350
2201静岡市保健所　　　 ,332451,350082,682533,21300,42244,14194,5116
2202浜松市保健所　　　 ,381284,385816,767100,27015,43635,16745,5646
2251賀茂保健所　　　　 ,28172,30860,59032,1004,6192,798,442
2253熱海保健所　　　　 ,45694,52887,98581,1667,9475,1472,846
2257御殿場保健所　　　 ,53188,49489,102677,3571,5580,2433,849
2258富士保健所　　　　 ,180256,185515,365771,11553,21100,7562,3440
2271東部保健所　　　　 ,257307,268304,525611,16282,33130,10504,4352
2272中部保健所　　　　 ,216058,225036,441094,13537,27455,8076,3223
2276西部保健所　　　　 ,251376,247159,498535,17363,28070,10146,3436
22100静岡市　　　　　　,332451,350082,682533,21300,42244,14194,5116
22101静岡市葵区　　　　,118497,127782,246279,7641,15563,4707,1797
22102静岡市駿河区　　　,102726,105476,208202,7465,11250,5339,1628
22103静岡市清水区　　　,111228,116824,228052,6194,15431,4148,1691
22130浜松市　　　　　　,381284,385816,767100,27015,43635,16745,5646
22131浜松市中区　　　　,113471,113519,226990,8239,12429,5525,1704
22132浜松市東区　　　　,62640,63254,125894,5285,6303,3227,1002
22133浜松市西区　　　　,52084,53331,105415,3272,6049,1900,737
22134浜松市南区　　　　,47677,47456,95133,3552,5244,2494,855
22135浜松市北区　　　　,44688,46082,90770,2723,5849,1490,596
22136浜松市浜北区　　　,47940,48585,96525,3531,4915,1852,644
22137浜松市天竜区　　　,12784,13589,26373,413,2846,257,108
22203沼津市　　　　　　,90950,94018,184968,5071,12820,3832,1584
22205熱海市　　　　　　,15236,18427,33663,460,3750,501,284
22206三島市　　　　　　,51783,54645,106428,3220,6122,1915,830
22207富士宮市　　　　　,62232,63710,125942,3746,7478,2363,1143
22208伊東市　　　　　　,30458,34460,64918,1207,5725,971,562
22209島田市　　　　　　,46169,48170,94339,3057,6097,1642,621
22210富士市　　　　　　,118024,121805,239829,7807,13622,5199,2297
22211磐田市　　　　　　,79684,78932,158616,5170,9005,3150,1051
22212焼津市　　　　　　,64838,67524,132362,4104,8123,2581,1044
22213掛川市　　　　　　,55636,55106,110742,4137,6284,2194,776
22214藤枝市　　　　　　,67990,71623,139613,4319,7956,2591,993
22215御殿場市　　　　　,43419,40886,84305,3097,4370,2043,736
22216袋井市　　　　　　,42127,41096,83223,3430,4061,2016,621
22219下田市　　　　　　,9615,10392,20007,389,1851,339,163
22220裾野市　　　　　　,25364,24788,50152,1902,2537,1184,410
22221湖西市　　　　　　,27799,26785,54584,1596,2992,1021,354
22222伊豆市　　　　　　,13282,14711,27993,536,2528,351,195
22223御前崎市　　　　　,15317,14780,30097,882,2002,555,222
22224菊川市　　　　　　,22342,21835,44177,1736,2426,980,308
22225伊豆の国市　　　　,22169,24028,46197,1257,3162,754,397
22226牧之原市　　　　　,20329,21074,41403,1057,2983,647,319
22301東伊豆町　　　　　,5402,5946,11348,141,1198,120,84
22302河津町　　　　　　,3302,3524,6826,136,699,114,63
22304南伊豆町　　　　　,3706,4126,7832,163,876,89,51
22305松崎町　　　　　　,2832,3185,6017,85,663,66,31
22306西伊豆町　　　　　,3315,3687,7002,90,905,70,50
22325函南町　　　　　　,17766,18741,36507,1145,2225,699,308
22341清水町　　　　　　,14775,15678,30453,1037,1814,649,262
22342長泉町　　　　　　,21218,21695,42913,2114,1922,1120,366
22344小山町　　　　　　,9769,8603,18372,474,1210,390,113
22424吉田町　　　　　　,13698,13560,27258,922,1526,556,222
22429川根本町　　　　　,3034,3085,6119,78,770,59,24
22461森町　　　　　　　,8471,8625,17096,412,1300,230,104
23愛知県　　　　　　　 ,3632555,3650705,7283260,279058,364235,181383,58899
2317名古屋市保健所　　 ,1107823,1142941,2250764,87628,118572,63676,19788
2331豊田市保健所　　　 ,211945,192904,404849,15386,16680,10592,3087
2332豊橋市保健所　　　 ,176642,176795,353437,12716,18936,7839,2862
2333岡崎市保健所　　　 ,187789,184509,372298,14901,15985,9403,2929
2334一宮市保健所　　　 ,181897,191428,373325,12950,19971,7729,2890
2354瀬戸保健所　　　　 ,227812,235279,463091,18186,20156,10041,3401
2355半田保健所　　　　 ,135167,135344,270511,9216,14531,5274,2084
2356春日井保健所　　　 ,219224,221121,440345,16562,20915,10747,3630
2357豊川保健所　　　　 ,156151,156242,312393,11076,17885,6601,2281
2358津島保健所　　　　 ,155641,160882,316523,10797,17640,6567,2735
2362西尾保健所　　　　 ,101348,99713,201061,7557,10342,4144,1563
2364江南保健所　　　　 ,132948,136622,269570,9400,14349,5750,1955
2367新城保健所　　　　 ,25566,26168,51734,1116,4461,601,282
2368知多保健所　　　　 ,172955,168180,341135,14077,15512,8467,2657
2369清須保健所　　　　 ,146970,149523,296493,12506,14719,7632,2376
2374衣浦東部保健所　　 ,292677,273054,565731,24984,23581,16320,4379
23100名古屋市　　　　　,1107823,1142941,2250764,87628,118572,63676,19788
23101名古屋市千種区　　,77176,81647,158823,5614,7635,4049,1099
23102名古屋市東区　　　,38838,41745,80583,3471,3669,2786,720
23103名古屋市北区　　　,76846,80818,157664,5635,9925,4396,1554
23104名古屋市西区　　　,72670,74163,146833,5812,7813,4536,1284
23105名古屋市中村区　　,67168,65734,132902,5111,8453,4798,1107
23106名古屋市中区　　　,41868,41545,83413,3346,3696,4681,1137
23107名古屋市昭和区　　,50956,52526,103482,4218,5357,2810,706
23108名古屋市瑞穂区　　,51113,55196,106309,4201,5753,2693,722
23109名古屋市熱田区　　,32298,32316,64614,2285,3692,1789,459
23110名古屋市中川区　　,105530,108175,213705,8585,11774,6686,2203
23111名古屋市港区　　　,67739,67242,134981,4230,8352,3224,1561
23112名古屋市南区　　　,65422,63215,128637,4385,8894,3473,1134
23113名古屋市守山区　　,84617,88671,173288,7284,8827,4152,1593
23114名古屋市緑区　　　,119358,124029,243387,10710,10321,6029,2003
23115名古屋市名東区　　,76964,83975,160939,6323,7143,3554,1225
23116名古屋市天白区　　,79260,81944,161204,6418,7268,4020,1281
23201豊橋市　　　　　　,176642,176795,353437,12716,18936,7839,2862
23202岡崎市　　　　　　,187789,184509,372298,14901,15985,9403,2929
23203一宮市　　　　　　,181897,191428,373325,12950,19971,7729,2890
23204瀬戸市　　　　　　,60519,63084,123603,3627,6992,1986,877
23205半田市　　　　　　,57145,56557,113702,4134,5827,2569,976
23206春日井市　　　　　,148548,152458,301006,11897,14136,7474,2451
23207豊川市　　　　　　,88581,89406,177987,6919,9452,4121,1427
23208津島市　　　　　　,28969,30526,59495,1472,3638,1003,497
23209碧南市　　　　　　,34404,32781,67185,2503,3630,1390,499
23210刈谷市　　　　　　,77558,71150,148708,7079,5923,5020,1115
23211豊田市　　　　　　,211945,192904,404849,15386,16680,10592,3087
23212安城市　　　　　　,92213,88044,180257,7864,7317,4903,1337
23213西尾市　　　　　　,80504,79369,159873,5653,8738,3139,1238
23214蒲郡市　　　　　　,37856,38484,76340,2353,4766,1477,517
23215犬山市　　　　　　,34853,35738,70591,1985,3988,1253,457
23216常滑市　　　　　　,27932,29405,57337,2015,3095,1120,417
23217江南市　　　　　　,47068,49336,96404,3052,5335,1832,686
23219小牧市　　　　　　,70676,68663,139339,4665,6779,3273,1179
23220稲沢市　　　　　　,64664,66769,131433,4569,7112,2622,869
23221新城市　　　　　　,21532,21869,43401,970,3375,525,249
23222東海市　　　　　　,58062,53589,111651,4932,4792,3154,964
23223大府市　　　　　　,45623,44281,89904,4327,3501,2518,606
23224知多市　　　　　　,41338,40905,82243,2803,4124,1675,670
23225知立市　　　　　　,35513,31609,67122,3139,2789,2358,543
23226尾張旭市　　　　　,39812,41892,81704,2932,3621,1495,595
23227高浜市　　　　　　,22075,20719,42794,1873,1979,1139,417
23228岩倉市　　　　　　,22466,22811,45277,2026,2282,1378,386
23229豊明市　　　　　　,33266,32713,65979,2511,3047,1678,485
23230日進市　　　　　　,44335,45688,90023,4421,3158,2590,661
23231田原市　　　　　　,29714,28352,58066,1804,3667,1003,337
23232愛西市　　　　　　,29127,30830,59957,1539,3826,805,414
23233清須市　　　　　　,32608,33040,65648,3507,3223,2161,586
23234北名古屋市　　　　,42008,42304,84312,3797,3729,2460,742
23235弥富市　　　　　　,20445,20860,41305,1582,2214,992,299
23236みよし市　　　　　,30914,28751,59665,2526,1943,1510,468
23237あま市　　　　　　,41469,42608,84077,3282,4453,1971,826
23238長久手市　　　　　,28630,30539,59169,3083,1605,1522,428
23302東郷町　　　　　　,21250,21363,42613,1612,1733,770,355
23342豊山町　　　　　　,7690,7410,15100,633,655,389,179
23361大口町　　　　　　,11984,11684,23668,1036,998,528,174
23362扶桑町　　　　　　,16577,17053,33630,1301,1746,759,252
23424大治町　　　　　　,15896,15711,31607,1386,1338,823,395
23425蟹江町　　　　　　,17639,18115,35754,1392,1876,938,278
23427飛島村　　　　　　,2096,2232,4328,144,295,35,26
23441阿久比町　　　　　,13781,14241,28022,1070,1345,411,201
23442東浦町　　　　　　,23928,24183,48111,1707,2491,993,326
23445南知多町　　　　　,7893,8334,16227,285,1437,202,89
23446美浜町　　　　　　,11058,11116,22174,483,1354,290,138
23447武豊町　　　　　　,21362,20913,42275,1537,2077,809,354
23501幸田町　　　　　　,20844,20344,41188,1904,1604,1005,325
23561設楽町　　　　　　,2151,2260,4411,72,546,36,17
23562東栄町　　　　　　,1409,1516,2925,62,405,26,15
23563豊根村　　　　　　,474,523,997,12,135,14,1
24三重県　　　　　　　 ,837934,880774,1718708,56882,107407,34961,13541
2431四日市市保健所　　 ,147424,147625,295049,10991,16308,7322,2447
2451桑名保健所　　　　 ,134950,138295,273245,9712,14422,5571,2088
2453鈴鹿保健所　　　　 ,117126,118114,235240,8426,12219,5368,2020
2454津保健所　　　　　 ,129151,137060,266211,8866,16600,5441,1989
2456松阪保健所　　　　 ,95969,103811,199780,6681,13352,3803,1688
2457伊勢保健所　　　　 ,106618,119401,226019,6190,17520,3605,1502
2458伊賀保健所　　　　 ,76706,81963,158669,4625,10629,2930,1344
2460尾鷲保健所　　　　 ,14127,16261,30388,562,3207,438,218
2461熊野保健所　　　　 ,15863,18244,34107,829,3150,483,245
24201津市　　　　　　　,129151,137060,266211,8866,16600,5441,1989
24202四日市市　　　　　,147424,147625,295049,10991,16308,7322,2447
24203伊勢市　　　　　　,57683,63969,121652,3924,7981,2218,867
24204松阪市　　　　　　,74617,80450,155067,5277,10073,3124,1346
24205桑名市　　　　　　,65816,68506,134322,4548,7072,2811,1009
24207鈴鹿市　　　　　　,93043,94327,187370,6707,9466,4453,1627
24208名張市　　　　　　,36321,39053,75374,2191,4252,1318,657
24209尾鷲市　　　　　　,7491,8573,16064,329,1597,259,127
24210亀山市　　　　　　,24083,23787,47870,1719,2753,915,393
24211鳥羽市　　　　　　,8194,9158,17352,386,1510,234,94
24212熊野市　　　　　　,7340,8520,15860,367,1606,220,108
24214いなべ市　　　　　,21906,21081,42987,1453,2632,780,302
24215志摩市　　　　　　,21120,24585,45705,922,4279,555,311
24216伊賀市　　　　　　,40385,42910,83295,2434,6377,1612,687
24303木曽岬町　　　　　,2796,2882,5678,105,367,68,53
24324東員町　　　　　　,12269,12922,25191,920,1217,420,162
24341菰野町　　　　　　,19331,20314,39645,1438,2132,729,314
24343朝日町　　　　　　,5379,5474,10853,494,389,242,83
24344川越町　　　　　　,7453,7116,14569,754,613,521,165
24441多気町　　　　　　,6712,7171,13883,365,1041,163,96
24442明和町　　　　　　,10565,11700,22265,833,1343,396,188
24443大台町　　　　　　,4075,4490,8565,206,895,120,58
24461玉城町　　　　　　,7137,7733,14870,510,864,267,116
24470度会町　　　　　　,3792,4006,7798,184,548,108,42
24471大紀町　　　　　　,3615,4117,7732,95,916,83,28
24472南伊勢町　　　　　,5077,5833,10910,169,1422,140,44
24543紀北町　　　　　　,6636,7688,14324,233,1610,179,91
24561御浜町　　　　　　,3762,4271,8033,161,731,85,48
24562紀宝町　　　　　　,4761,5453,10214,301,813,178,89
25滋賀県　　　　　　　 ,679646,700840,1380486,52310,68223,30147,9928
2531大津市保健所　　　 ,164187,175875,340062,12286,16153,6929,2368
2553草津保健所　　　　 ,169264,170803,340067,15323,12726,8507,2385
2554甲賀保健所　　　　 ,68205,67626,135831,4663,6912,2886,1032
2555東近江保健所　　　 ,109263,111352,220615,8138,12037,4826,1656
2557彦根保健所　　　　 ,74841,76545,151386,5445,8056,3288,1222
2558長浜保健所　　　　 ,71378,75249,146627,5170,8983,2922,996
2560高島保健所　　　　 ,22508,23390,45898,1285,3356,789,269
25201大津市　　　　　　,164187,175875,340062,12286,16153,6929,2368
25202彦根市　　　　　　,55150,55856,111006,3983,5539,2533,883
25203長浜市　　　　　　,53567,56372,109939,3906,6688,2248,770
25204近江八幡市　　　　,38862,40773,79635,3107,4199,1763,568
25206草津市　　　　　　,70702,69913,140615,5562,4862,3095,837
25207守山市　　　　　　,40414,41708,82122,3723,3158,1890,553
25208栗東市　　　　　　,33410,34059,67469,4022,2375,2358,669
25209甲賀市　　　　　　,41918,42811,84729,2864,4737,1720,594
25210野洲市　　　　　　,24738,25123,49861,2016,2331,1164,326
25211湖南市　　　　　　,26287,24815,51102,1799,2175,1166,438
25212高島市　　　　　　,22508,23390,45898,1285,3356,789,269
25213東近江市　　　　　,54118,54845,108963,4025,5873,2470,858
25214米原市　　　　　　,17811,18877,36688,1264,2295,674,226
25383日野町　　　　　　,10162,10177,20339,657,1322,399,167
25384竜王町　　　　　　,6121,5557,11678,349,643,194,63
25425愛荘町　　　　　　,9816,10076,19892,791,1010,451,191
25441豊郷町　　　　　　,3345,3599,6944,231,450,121,58
25442甲良町　　　　　　,3039,3268,6307,155,504,82,40
25443多賀町　　　　　　,3491,3746,7237,285,553,101,50
26京都府　　　　　　　 ,1202697,1317315,2520012,82228,140349,52173,18982
2626京都市保健所　　　 ,670407,749291,1419698,45874,77032,32704,10907
2651乙訓保健所　　　　 ,72952,79130,152082,6313,6963,3125,989
2654山城南保健所　　　 ,57333,62811,120144,4326,5146,1878,856
2659中丹西保健所　　　 ,38067,38188,76255,3117,5024,1715,603
2663山城北保健所　　　 ,204043,218802,422845,12807,22016,7238,3198
2664南丹保健所　　　　 ,62446,66779,129225,3671,8346,1991,967
2665中丹東保健所　　　 ,54826,55959,110785,3677,8091,2164,891
2666丹後保健所　　　　 ,42623,46355,88978,2443,7731,1358,571
26100京都市　　　　　　,670407,749291,1419698,45874,77032,32704,10907
26101京都市北区　　　　,54286,60065,114351,3006,6456,1813,728
26102京都市上京区　　　,37046,43907,80953,1902,4675,1523,460
26103京都市左京区　　　,76161,82471,158632,4435,8488,2710,950
26104京都市中京区　　　,49188,58455,107643,3553,5539,2874,746
26105京都市東山区　　　,15637,19956,35593,754,2659,727,226
26106京都市下京区　　　,36826,43341,80167,2710,4106,2520,555
26107京都市南区　　　　,48145,48717,96862,4116,5111,3264,858
26108京都市右京区　　　,92333,104324,196657,6572,10708,4386,1520
26109京都市伏見区　　　,128535,140499,269034,9213,15090,6443,2446
26110京都市山科区　　　,62421,70340,132761,4241,7268,3235,1204
26111京都市西京区　　　,69829,77216,147045,5372,6932,3209,1214
26201福知山市　　　　　,38067,38188,76255,3117,5024,1715,603
26202舞鶴市　　　　　　,39749,39643,79392,2763,5359,1646,660
26203綾部市　　　　　　,15077,16316,31393,914,2732,518,231
26204宇治市　　　　　　,85039,92038,177077,5404,9325,3196,1447
26205宮津市　　　　　　,7910,8721,16631,392,1619,266,106
26206亀岡市　　　　　　,41186,44001,85187,2610,4519,1359,669
26207城陽市　　　　　　,35479,38386,73865,2182,4253,1275,462
26208向日市　　　　　　,26863,29485,56348,2310,2612,1137,419
26209長岡京市　　　　　,38436,41457,79893,3108,3634,1594,457
26210八幡市　　　　　　,33061,35696,68757,1832,3672,1157,552
26211京田辺市　　　　　,35555,37167,72722,2554,2883,1048,456
26212京丹後市　　　　　,24251,26182,50433,1469,4231,796,330
26213南丹市　　　　　　,15200,16082,31282,823,2534,491,220
26214木津川市　　　　　,36990,40304,77294,3153,3035,1257,587
26303大山崎町　　　　　,7653,8188,15841,895,717,394,113
26322久御山町　　　　　,7170,7504,14674,441,841,289,141
26343井手町　　　　　　,3494,3704,7198,183,516,132,68
26344宇治田原町　　　　,4245,4307,8552,211,526,141,72
26364笠置町　　　　　　,540,601,1141,9,152,13,8
26365和束町　　　　　　,1610,1852,3462,58,340,47,34
26366精華町　　　　　　,17077,18799,35876,1073,1405,540,212
26367南山城村　　　　　,1116,1255,2371,33,214,21,15
26407京丹波町　　　　　,6060,6696,12756,238,1293,141,78
26463伊根町　　　　　　,944,976,1920,65,214,23,10
26465与謝野町　　　　　,9518,10476,19994,517,1667,273,125
27大阪府　　　　　　　 ,4116865,4478618,8595483,306976,475107,211116,76413
2701堺市保健所　　　　 ,386336,424934,811270,28836,45379,18327,6933
2729大阪市保健所　　　 ,1260619,1353729,2614348,99299,154053,84258,26931
2731吹田市保健所　　　 ,182642,197373,380015,15168,15875,8532,2433
2744東大阪市保健所　　 ,230328,244022,474350,15276,28077,11134,4444
2745高槻市保健所　　　 ,166428,182879,349307,12257,17574,7050,2310
2746豊中市保健所　　　 ,186353,209884,396237,16442,19759,8959,3043
2747枚方市保健所　　　 ,185951,206791,392742,12586,20017,7261,2853
2748八尾市保健所　　　 ,122019,134991,257010,9157,15263,5518,2208
2749寝屋川市保健所　　 ,109198,117476,226674,7407,13132,4598,2061
2751池田保健所　　　　 ,125472,138798,264270,8512,13004,4544,1861
2754茨木保健所　　　　 ,193683,207015,400698,16581,17531,9938,2983
2758守口保健所　　　　 ,125044,131969,257013,8839,16091,6442,2543
2759四條畷保健所　　　 ,118531,127202,245733,8163,12593,5046,2166
2763藤井寺保健所　　　 ,167731,186019,353750,10916,21157,7062,3171
2765富田林保健所　　　 ,140493,159159,299652,8474,17414,4900,2349
2766和泉保健所　　　　 ,155705,170388,326093,11454,16441,7014,2954
2768岸和田保健所　　　 ,128893,142484,271377,9225,16046,5305,2672
2770泉佐野保健所　　　 ,131439,143505,274944,8384,15701,5228,2498
27100大阪市　　　　　　,1260619,1353729,2614348,99299,154053,84258,26931
27102大阪市都島区　　　,50019,54455,104474,3826,5361,3116,931
27103大阪市福島区　　　,36860,40840,77700,3956,3085,3300,710
27104大阪市此花区　　　,30585,32585,63170,2125,3943,1607,648
27106大阪市西区　　　　,47333,53776,101109,5020,3258,4793,1216
27107大阪市港区　　　　,37889,39861,77750,2513,4989,2058,761
27108大阪市大正区　　　,29348,31192,60540,1715,4497,1310,698
27109大阪市天王寺区　　,35800,41599,77399,3516,3070,2499,746
27111大阪市浪速区　　　,33917,32188,66105,2531,3376,3537,927
27113大阪市西淀川区　　,44969,46807,91776,3271,5304,2595,926
27114大阪市東淀川区　　,83046,86804,169850,5939,9516,5996,1761
27115大阪市東成区　　　,36921,40736,77657,2984,4429,2739,750
27116大阪市生野区　　　,47174,52404,99578,3563,8190,3175,1178
27117大阪市旭区　　　　,41642,45830,87472,3036,6027,2241,786
27118大阪市城東区　　　,77786,86113,163899,6769,8988,4710,1491
27119大阪市阿倍野区　　,49536,58161,107697,4103,5857,2539,781
27120大阪市住吉区　　　,69581,80091,149672,5361,9299,3879,1468
27121大阪市東住吉区　　,58381,65833,124214,4590,9193,3322,1279
27122大阪市西成区　　　,57623,41156,98779,1838,13569,2116,1016
27123大阪市淀川区　　　,87794,88309,176103,7006,8286,7147,1837
27124大阪市鶴見区　　　,52124,58426,110550,4991,5381,2726,1048
27125大阪市住之江区　　,55619,60278,115897,3332,7659,2461,1234
27126大阪市平野区　　　,86435,97307,183742,6221,12580,4366,2084
27127大阪市北区　　　　,65049,68548,133597,6326,4987,6509,1417
27128大阪市中央区　　　,45188,50430,95618,4767,3209,5517,1238
27140堺市　　　　　　　,386336,424934,811270,28836,45379,18327,6933
27141堺市堺区　　　　　,71074,72529,143603,4851,8776,3924,1220
27142堺市中区　　　　　,57308,62397,119705,4574,6480,2693,1306
27143堺市東区　　　　　,39943,44269,84212,2966,4940,1680,622
27144堺市西区　　　　　,63503,69966,133469,4788,7456,3076,1270
27145堺市南区　　　　　,62716,72989,135705,3270,7691,1801,992
27146堺市北区　　　　　,74070,83570,157640,7414,7802,4524,1177
27147堺市美原区　　　　,17722,19214,36936,973,2234,629,346
27202岸和田市　　　　　,88912,99008,187920,6639,11348,3885,1914
27203豊中市　　　　　　,186353,209884,396237,16442,19759,8959,3043
27204池田市　　　　　　,48738,53944,102682,3505,5078,2180,738
27205吹田市　　　　　　,182642,197373,380015,15168,15875,8532,2433
27206泉大津市　　　　　,34489,38408,72897,2713,3784,1803,675
27207高槻市　　　　　　,166428,182879,349307,12257,17574,7050,2310
27208貝塚市　　　　　　,39981,43476,83457,2586,4698,1420,758
27209守口市　　　　　　,67927,72526,140453,5390,8725,3429,1326
27210枚方市　　　　　　,185951,206791,392742,12586,20017,7261,2853
27211茨木市　　　　　　,136888,147220,284108,11526,12158,6994,1993
27212八尾市　　　　　　,122019,134991,257010,9157,15263,5518,2208
27213泉佐野市　　　　　,46920,51213,98133,3180,5444,2154,950
27214富田林市　　　　　,50146,57138,107284,3119,6275,1914,908
27215寝屋川市　　　　　,109198,117476,226674,7407,13132,4598,2061
27216河内長野市　　　　,47043,54005,101048,2415,6380,1543,674
27217松原市　　　　　　,55479,60262,115741,3683,7206,2423,1106
27218大東市　　　　　　,56491,60053,116544,3877,6153,2631,1193
27219和泉市　　　　　　,87387,94568,181955,6070,8365,3529,1600
27220箕面市　　　　　　,63788,70630,134418,4663,5949,2074,946
27221柏原市　　　　　　,32178,35212,67390,1957,3733,1302,509
27222羽曳野市　　　　　,50520,57160,107680,3223,6697,2023,975
27223門真市　　　　　　,57117,59443,116560,3449,7366,3013,1217
27224摂津市　　　　　　,42293,43595,85888,3811,3983,2405,848
27225高石市　　　　　　,26091,29022,55113,2172,3279,1328,520
27226藤井寺市　　　　　,29554,33385,62939,2053,3521,1314,581
27227東大阪市　　　　　,230328,244022,474350,15276,28077,11134,4444
27228泉南市　　　　　　,28380,31057,59437,2005,3392,1163,562
27229四條畷市　　　　　,26483,28174,54657,1773,2801,1096,447
27230交野市　　　　　　,35557,38975,74532,2513,3639,1319,526
27231大阪狭山市　　　　,27201,30798,57999,2188,2827,975,476
27232阪南市　　　　　　,24068,26839,50907,1243,3095,834,440
27301島本町　　　　　　,14502,16200,30702,1244,1390,539,142
27321豊能町　　　　　　,8634,9552,18186,215,1220,155,99
27322能勢町　　　　　　,4312,4672,8984,129,757,135,78
27341忠岡町　　　　　　,7738,8390,16128,499,1013,354,159
27361熊取町　　　　　　,21163,22336,43499,1375,2135,702,349
27362田尻町　　　　　　,4124,4200,8324,328,410,167,79
27366岬町　　　　　　　,6784,7860,14644,253,1225,208,118
27381太子町　　　　　　,6248,6638,12886,322,639,202,110
27382河南町　　　　　　,7544,7997,15541,353,870,208,157
27383千早赤阪村　　　　,2311,2583,4894,77,423,58,24
28兵庫県　　　　　　　 ,2546706,2809942,5356648,183855,302565,113387,42568
2812神戸市保健所　　　 ,693873,785292,1479165,48532,82135,32740,12212
2837尼崎市保健所　　　 ,216160,231176,447336,17975,26504,13223,4238
2838姫路市保健所　　　 ,251414,268266,519680,19448,28867,12129,4633
2839西宮市保健所　　　 ,222588,255396,477984,18092,21398,10452,3369
2840あかし保健所　　　 ,144776,155102,299878,13447,15143,7477,2595
2852芦屋保健所　　　　 ,41211,51105,92316,2764,4805,1536,570
2853伊丹保健所　　　　 ,178861,197097,375958,12708,19241,7063,3020
2854宝塚保健所　　　　 ,154315,177770,332085,10505,15952,5213,2209
2858加古川保健所　　　 ,198246,209144,407390,13959,21884,8513,3305
2863加東保健所　　　　 ,124759,132635,257394,7484,16138,4418,1922
2864龍野保健所　　　　 ,75858,81450,157308,4517,10621,2591,1082
2865赤穂保健所　　　　 ,41916,45317,87233,2342,6101,1309,566
2866福崎保健所　　　　 ,19626,20916,40542,1101,2946,655,290
2869豊岡保健所　　　　 ,50951,55039,105990,3038,8518,1696,707
2871朝来保健所　　　　 ,24402,26282,50684,1495,4349,748,307
2872丹波保健所　　　　 ,47545,51815,99360,2997,7517,1662,681
2874洲本保健所　　　　 ,60205,66140,126345,3451,10446,1962,862
28100神戸市　　　　　　,693873,785292,1479165,48532,82135,32740,12212
28101神戸市東灘区　　　,96379,111154,207533,7648,9378,4561,1546
28102神戸市灘区　　　　,61545,71070,132615,4744,6943,3097,1084
28105神戸市兵庫区　　　,49894,53521,103415,3576,7386,3528,1045
28106神戸市長田区　　　,41352,46791,88143,2563,7232,2403,935
28107神戸市須磨区　　　,71483,83843,155326,5106,9340,2959,1175
28108神戸市垂水区　　　,99127,113648,212775,7222,12503,3849,1721
28109神戸市北区　　　　,98422,109882,208304,5846,11748,3456,1613
28110神戸市中央区　　　,62329,72794,135123,5169,6372,4765,1261
28111神戸市西区　　　　,113342,122589,235931,6658,11233,4122,1832
28201姫路市　　　　　　,251414,268266,519680,19448,28867,12129,4633
28202尼崎市　　　　　　,216160,231176,447336,17975,26504,13223,4238
28203明石市　　　　　　,144776,155102,299878,13447,15143,7477,2595
28204西宮市　　　　　　,222588,255396,477984,18092,21398,10452,3369
28205洲本市　　　　　　,19498,21439,40937,1129,3228,712,296
28206芦屋市　　　　　　,41211,51105,92316,2764,4805,1536,570
28207伊丹市　　　　　　,94273,101063,195336,7787,9219,4444,1768
28208相生市　　　　　　,13373,14575,27948,903,2050,460,176
28209豊岡市　　　　　　,37071,39760,76831,2387,5796,1368,558
28210加古川市　　　　　,125928,132002,257930,8988,13476,5494,2072
28212赤穂市　　　　　　,21889,23636,45525,1238,2986,691,321
28213西脇市　　　　　　,18166,19797,37963,1082,2614,668,275
28214宝塚市　　　　　　,102415,121314,223729,7336,11311,3549,1483
28215三木市　　　　　　,35328,38244,73572,1980,4555,1229,531
28216高砂市　　　　　　,41769,44769,86538,2904,5000,1885,750
28217川西市　　　　　　,70694,80437,151131,4392,8512,2358,1069
28218小野市　　　　　　,22744,23929,46673,1494,2534,773,397
28219三田市　　　　　　,51900,56456,108356,3169,4641,1664,726
28220加西市　　　　　　,20378,21050,41428,1027,2866,650,280
28221丹波篠山市　　　　,18570,20257,38827,1129,3008,639,286
28222養父市　　　　　　,10596,11427,22023,617,2035,303,103
28223丹波市　　　　　　,28975,31558,60533,1868,4509,1023,395
28224南あわじ市　　　　,20978,22780,43758,1253,3491,657,324
28225朝来市　　　　　　,13806,14855,28661,878,2314,445,204
28226淡路市　　　　　　,19729,21921,41650,1069,3727,593,242
28227宍粟市　　　　　　,16567,18014,34581,882,2817,545,231
28228加東市　　　　　　,19026,19754,38780,1516,2092,893,327
28229たつの市　　　　　,35650,38122,73772,2164,4697,1215,511
28301猪名川町　　　　　,13894,15597,29491,529,1510,261,183
28365多可町　　　　　　,9117,9861,18978,385,1477,205,112
28381稲美町　　　　　　,14508,15316,29824,857,1696,453,219
28382播磨町　　　　　　,16041,17057,33098,1210,1712,681,264
28442市川町　　　　　　,5402,5697,11099,200,961,160,80
28443福崎町　　　　　　,9288,9601,18889,645,1100,339,136
28446神河町　　　　　　,4936,5618,10554,256,885,156,74
28464太子町　　　　　　,16138,17097,33235,1155,1589,636,252
28481上郡町　　　　　　,6654,7106,13760,201,1065,158,69
28501佐用町　　　　　　,7503,8217,15720,316,1518,195,88
28585香美町　　　　　　,7623,8342,15965,352,1503,176,88
28586新温泉町　　　　　,6257,6937,13194,299,1219,152,61
29奈良県　　　　　　　 ,617815,693915,1311730,40167,76751,23697,9519
2931奈良市保健所　　　 ,163107,187802,350909,10496,19633,6286,2382
2952郡山保健所　　　　 ,161110,178458,339568,10584,18390,5912,2329
2956吉野保健所　　　　 ,30556,33770,64326,1098,6097,938,453
2957中和保健所　　　　 ,263042,293885,556927,17989,32631,10561,4355
29201奈良市　　　　　　,163107,187802,350909,10496,19633,6286,2382
29202大和高田市　　　　,28746,32448,61194,1682,3980,1234,557
29203大和郡山市　　　　,38928,43618,82546,2403,4782,1576,585
29204天理市　　　　　　,30820,32235,63055,2167,3481,1302,428
29205橿原市　　　　　　,56794,63083,119877,4250,6132,2702,925
29206桜井市　　　　　　,25622,28611,54233,1654,3426,1049,490
29207五條市　　　　　　,13074,14573,27647,498,2347,405,197
29208御所市　　　　　　,11024,12788,23812,483,2216,370,183
29209生駒市　　　　　　,54436,60945,115381,3556,5307,1762,745
29210香芝市　　　　　　,36674,40873,77547,3203,3114,1655,599
29211葛城市　　　　　　,17316,19164,36480,1410,1844,634,273
29212宇陀市　　　　　　,13276,14607,27883,458,2435,333,188
29322山添村　　　　　　,1526,1666,3192,42,354,28,14
29342平群町　　　　　　,8394,9515,17909,420,1181,217,121
29343三郷町　　　　　　,10816,12254,23070,792,1345,443,186
29344斑鳩町　　　　　　,12886,14517,27403,1024,1454,448,195
29345安堵町　　　　　　,3304,3708,7012,180,486,136,55
29361川西町　　　　　　,3844,4163,8007,197,503,109,48
29362三宅町　　　　　　,3011,3345,6356,161,447,88,45
29363田原本町　　　　　,14760,16190,30950,1107,1822,670,287
29385曽爾村　　　　　　,586,694,1280,23,148,15,5
29386御杖村　　　　　　,688,782,1470,16,219,13,3
29401高取町　　　　　　,3137,3583,6720,93,539,69,35
29402明日香村　　　　　,2433,2731,5164,123,428,70,26
29424上牧町　　　　　　,10053,11524,21577,486,1569,325,178
29425王寺町　　　　　　,11276,12571,23847,1068,1175,508,181
29426広陵町　　　　　　,15938,17686,33624,1215,1516,490,234
29427河合町　　　　　　,7864,9042,16906,360,1118,227,98
29441吉野町　　　　　　,2797,3367,6164,71,832,73,42
29442大淀町　　　　　　,7835,8682,16517,293,1204,235,145
29443下市町　　　　　　,2342,2658,5000,62,578,59,23
29444黒滝村　　　　　　,292,325,617,20,94,16,8
29446天川村　　　　　　,566,609,1175,18,131,12,4
29447野迫川村　　　　　,171,180,351,3,39,5,-
29449十津川村　　　　　,1651,1392,3043,61,317,67,12
29450下北山村　　　　　,356,390,746,22,95,19,5
29451上北山村　　　　　,226,217,443,8,57,12,2
29452川上村　　　　　　,544,599,1143,25,193,18,10
29453東吉野村　　　　　,702,778,1480,17,210,17,5
30和歌山県　　　　　　 ,432415,483764,916179,28423,65747,17629,7638
3033和歌山市保健所　　 ,166646,186787,353433,12417,23076,7972,3121
3051海南保健所　　　　 ,26234,30098,56332,1305,4785,828,348
3052岩出保健所　　　　 ,53348,58611,111959,3617,6476,2224,1098
3053橋本保健所　　　　 ,39167,44014,83181,2206,6058,1302,600
3054湯浅保健所　　　　 ,32761,36632,69393,1993,5302,1200,510
3055御坊保健所　　　　 ,28927,31081,60008,1791,4791,1050,451
3056田辺保健所　　　　 ,56637,63665,120302,3641,9369,2130,999
3058新宮保健所　　　　 ,28695,32876,61571,1453,5890,923,511
30201和歌山市　　　　　,166646,186787,353433,12417,23076,7972,3121
30202海南市　　　　　　,22454,25657,48111,1184,3902,742,301
30203橋本市　　　　　　,28503,31995,60498,1693,3977,978,449
30204有田市　　　　　　,12504,13886,26390,649,1906,458,192
30205御坊市　　　　　　,11342,11971,23313,681,1600,475,205
30206田辺市　　　　　　,32706,36896,69602,2143,5307,1310,589
30207新宮市　　　　　　,12538,14454,26992,775,2242,485,240
30208紀の川市　　　　　,27595,30810,58405,1564,4164,1010,489
30209岩出市　　　　　　,25753,27801,53554,2053,2312,1214,609
30304紀美野町　　　　　,3780,4441,8221,121,883,86,47
30341かつらぎ町　　　　,7398,8492,15890,402,1355,227,109
30343九度山町　　　　　,1781,2071,3852,55,412,39,19
30344高野町　　　　　　,1485,1456,2941,56,314,58,23
30361湯浅町　　　　　　,5177,5907,11084,275,925,186,79
30362広川町　　　　　　,3162,3575,6737,143,503,101,45
30366有田川町　　　　　,11918,13264,25182,926,1968,455,194
30381美浜町　　　　　　,3209,3629,6838,181,613,96,54
30382日高町　　　　　　,3650,4006,7656,301,499,128,53
30383由良町　　　　　　,2655,2672,5327,105,562,79,32
30390印南町　　　　　　,3644,4044,7688,238,656,107,38
30391みなべ町　　　　　,5588,6152,11740,333,924,181,61
30392日高川町　　　　　,4427,4759,9186,285,861,165,69
30401白浜町　　　　　　,9385,10715,20100,488,1836,290,172
30404上富田町　　　　　,7228,7969,15197,610,836,300,154
30406すさみ町　　　　　,1730,1933,3663,67,466,49,23
30421那智勝浦町　　　　,6499,7530,14029,294,1330,188,110
30422太地町　　　　　　,1226,1555,2781,54,337,26,14
30424古座川町　　　　　,1129,1339,2468,38,351,23,19
30427北山村　　　　　　,183,221,404,11,39,6,4
30428串本町　　　　　　,7120,7777,14897,281,1591,195,124
31鳥取県　　　　　　　 ,262748,286018,548766,19421,37646,10774,4164
3131鳥取市保健所　　　 ,107818,115011,222829,7653,14393,4298,1583
3153倉吉保健所　　　　 ,46623,51793,98416,3399,7725,1648,687
3154米子保健所　　　　 ,108307,119214,227521,8369,15528,4828,1894
31201鳥取市　　　　　　,90736,96313,187049,6680,11211,3778,1375
31202米子市　　　　　　,69263,76709,145972,6058,8799,3567,1302
31203倉吉市　　　　　　,21710,24454,46164,1627,3490,857,314
31204境港市　　　　　　,15637,16601,32238,1029,2268,620,272
31302岩美町　　　　　　,5139,5580,10719,333,929,170,65
31325若桜町　　　　　　,1351,1483,2834,44,343,32,11
31328智頭町　　　　　　,2989,3370,6359,139,621,84,29
31329八頭町　　　　　　,7603,8265,15868,457,1289,234,103
31364三朝町　　　　　　,2850,3148,5998,120,561,67,33
31370湯梨浜町　　　　　,7639,8325,15964,654,1266,272,131
31371琴浦町　　　　　　,7630,8536,16166,529,1361,226,117
31372北栄町　　　　　　,6794,7330,14124,469,1047,226,92
31384日吉津村　　　　　,1617,1851,3468,170,184,81,35
31386大山町　　　　　　,7343,7908,15251,376,1436,182,94
31389南部町　　　　　　,4885,5345,10230,255,778,103,76
31390伯耆町　　　　　　,5036,5612,10648,305,830,163,72
31401日南町　　　　　　,1964,2204,4168,75,563,45,18
31402日野町　　　　　　,1322,1562,2884,48,357,33,11
31403江府町　　　　　　,1240,1422,2662,53,313,34,14
32島根県　　　　　　　 ,319954,342161,662115,22530,49304,12199,4399
3231松江市・島根県共同保健所 ,97812,104296,202108,7508,12286,4239,1341
3253雲南保健所　　　　 ,25093,26994,52087,1273,4879,682,247
3254出雲保健所　　　　 ,80906,87196,168102,6842,10766,3571,1173
3257浜田保健所　　　　 ,37871,38711,76582,2214,6580,1256,550
3258益田保健所　　　　 ,27257,30060,57317,1736,4994,902,435
3261県央保健所　　　　 ,24027,26096,50123,1350,5021,704,316
3262隠岐保健所　　　　 ,9345,9658,19003,601,1756,307,125
3263松江市・島根県共同保健所 ,17643,19150,36793,1006,3022,538,212
32201松江市　　　　　　,97812,104296,202108,7508,12286,4239,1341
32202浜田市　　　　　　,27074,26835,53909,1624,4510,925,404
32203出雲市　　　　　　,80906,87196,168102,6842,10766,3571,1173
32204益田市　　　　　　,21224,23414,44638,1414,3661,733,362
32205大田市　　　　　　,15572,16906,32478,910,3044,477,207
32206安来市　　　　　　,17643,19150,36793,1006,3022,538,212
32207江津市　　　　　　,10797,11876,22673,590,2070,331,146
32209雲南市　　　　　　,17262,18530,35792,912,3196,481,173
32343奥出雲町　　　　　,5684,6076,11760,258,1149,144,45
32386飯南町　　　　　　,2147,2388,4535,103,534,57,29
32441川本町　　　　　　,1552,1677,3229,83,338,41,15
32448美郷町　　　　　　,2074,2263,4337,87,514,62,37
32449邑南町　　　　　　,4829,5250,10079,270,1125,124,57
32501津和野町　　　　　,3216,3607,6823,146,743,85,46
32505吉賀町　　　　　　,2817,3039,5856,176,590,84,27
32525海士町　　　　　　,1107,1148,2255,65,171,45,13
32526西ノ島町　　　　　,1407,1350,2757,76,318,44,16
32527知夫村　　　　　　,321,310,631,25,47,14,5
32528隠岐の島町　　　　,6510,6850,13360,435,1220,204,91
33岡山県　　　　　　　 ,893546,965466,1859012,67179,113919,39820,14696
3301岡山市保健所　　　 ,341544,369497,711041,27767,35955,17268,5753
3334倉敷市保健所　　　 ,225241,243004,468245,19264,24920,11400,4059
3354備中保健所　　　　 ,105447,113922,219369,6833,15328,3555,1486
3358備北保健所　　　　 ,26985,28966,55951,1217,5538,741,316
3361真庭保健所　　　　 ,20638,22590,43228,1208,4067,687,287
3362美作保健所　　　　 ,82570,89219,171789,5921,13290,3294,1378
3370備前保健所　　　　 ,91121,98268,189389,4969,14821,2875,1417
33100岡山市　　　　　　,341544,369497,711041,27767,35955,17268,5753
33101岡山市北区　　　　,149531,157664,307195,11840,14873,7870,2282
33102岡山市中区　　　　,68957,78002,146959,6250,7128,3422,1314
33103岡山市東区　　　　,43488,47984,91472,2921,5595,1787,706
33104岡山市南区　　　　,79568,85847,165415,6756,8359,4189,1451
33202倉敷市　　　　　　,225241,243004,468245,19264,24920,11400,4059
33203津山市　　　　　　,47600,51401,99001,3610,6484,2104,852
33204玉野市　　　　　　,27133,28727,55860,1440,4441,896,405
33205笠岡市　　　　　　,21641,23919,45560,1011,3824,657,277
33207井原市　　　　　　,18190,19667,37857,970,3206,577,246
33208総社市　　　　　　,32633,34642,67275,2656,3587,1306,500
33209高梁市　　　　　　,13655,14497,28152,591,2768,375,157
33210新見市　　　　　　,13330,14469,27799,626,2770,366,159
33211備前市　　　　　　,15130,16609,31739,786,2802,492,218
33212瀬戸内市　　　　　,17130,18470,35600,946,2608,547,240
33213赤磐市　　　　　　,20184,21978,42162,1332,2667,639,359
33214真庭市　　　　　　,20268,22158,42426,1182,3976,668,277
33215美作市　　　　　　,12199,13355,25554,622,2540,351,156
33216浅口市　　　　　　,15689,16847,32536,903,2419,480,207
33346和気町　　　　　　,6335,7035,13370,255,1232,173,123
33423早島町　　　　　　,5905,6396,12301,561,627,224,106
33445里庄町　　　　　　,5156,5639,10795,376,556,158,77
33461矢掛町　　　　　　,6233,6812,13045,356,1109,153,73
33586新庄村　　　　　　,370,432,802,26,91,19,10
33606鏡野町　　　　　　,5783,6194,11977,436,1129,182,91
33622勝央町　　　　　　,5187,5655,10842,474,721,234,99
33623奈義町　　　　　　,2774,2778,5552,260,436,162,55
33643西粟倉村　　　　　,647,745,1392,44,126,19,8
33663久米南町　　　　　,2162,2331,4493,111,474,54,36
33666美咲町　　　　　　,6218,6760,12978,364,1380,188,81
33681吉備中央町　　　　,5209,5449,10658,210,1071,128,72
34広島県　　　　　　　 ,1330215,1416596,2746811,97542,159541,59562,21264
3409広島市保健所　　　 ,570075,611054,1181129,45524,54640,28428,9451
3436福山市保健所　　　 ,219229,232052,451281,17423,25906,10517,3768
3437呉市保健所　　　　 ,102097,109365,211462,5840,16408,3931,1487
3460東部保健所　　　　 ,132126,144658,276784,7156,22646,4238,1880
3473西部保健所　　　　 ,156037,167157,323194,11404,20853,6531,2429
3475西部東保健所　　　 ,110941,108793,219734,7730,11214,4571,1653
3477北部保健所　　　　 ,39710,43517,83227,2465,7874,1346,596
34100広島市　　　　　　,570075,611054,1181129,45524,54640,28428,9451
34101広島市中区　　　　,65712,72651,138363,4987,6571,4218,1230
34102広島市東区　　　　,56000,61512,117512,4393,5889,2455,939
34103広島市南区　　　　,70459,73187,143646,5452,6704,3526,1050
34104広島市西区　　　　,88865,96864,185729,7483,8208,5294,1524
34105広島市安佐南区　　,119255,125539,244794,11200,9020,6058,1939
34106広島市安佐北区　　,65145,71906,137051,3674,8383,2221,1113
34107広島市安芸区　　　,37563,38063,75626,2883,3555,1791,557
34108広島市佐伯区　　　,67076,71332,138408,5452,6310,2865,1099
34202呉市　　　　　　　,102097,109365,211462,5840,16408,3931,1487
34203竹原市　　　　　　,11327,12431,23758,503,2134,351,171
34204三原市　　　　　　,42017,46368,88385,2382,6864,1462,671
34205尾道市　　　　　　,61319,66974,128293,3466,10405,1985,860
34207福山市　　　　　　,219229,232052,451281,17423,25906,10517,3768
34208府中市　　　　　　,17809,19266,37075,806,2967,496,221
34209三次市　　　　　　,23892,26126,50018,1616,4407,874,390
34210庄原市　　　　　　,15818,17391,33209,849,3467,472,206
34211大竹市　　　　　　,12636,13356,25992,789,1826,512,172
34212東広島市　　　　　,96050,92914,188964,7104,8240,4150,1462
34213廿日市市　　　　　,53758,59079,112837,3903,6120,2119,861
34214安芸高田市　　　　,12295,13457,25752,593,2551,395,199
34215江田島市　　　　　,10647,10696,21343,407,2308,355,148
34302府中町　　　　　　,24703,25814,50517,2464,2243,1322,369
34304海田町　　　　　　,14174,14606,28780,1572,1296,921,242
34307熊野町　　　　　　,10862,11768,22630,649,1399,324,201
34309坂町　　　　　　　,5866,6534,12400,485,790,243,94
34368安芸太田町　　　　,2666,3032,5698,86,700,56,27
34369北広島町　　　　　,8430,8815,17245,456,1620,284,116
34431大崎上島町　　　　,3564,3448,7012,123,840,70,20
34462世羅町　　　　　　,7070,7799,14869,354,1454,193,87
34545神石高原町　　　　,3911,4251,8162,148,956,102,41
35山口県　　　　　　　 ,629146,696897,1326043,41701,96487,25143,9933
3531下関市保健所　　　 ,116748,134112,250860,7479,18875,4647,1948
3552岩国環境保健所　　 ,63056,70025,133081,4299,10242,2697,1045
3554柳井環境保健所　　 ,34577,39334,73911,1573,7380,944,473
3555周南環境保健所　　 ,116243,124353,240596,8432,15984,5103,1829
3557山口環境保健所　　 ,91589,100646,192235,6625,11373,3748,1318
3558宇部環境保健所　　 ,115805,127539,243344,7590,17330,4544,1925
3563長門環境保健所　　 ,14866,17192,32058,664,3054,396,191
3564萩環境保健所　　　 ,21844,25424,47268,919,4896,609,294
3565防府保健所　　　　 ,54418,58272,112690,4120,7353,2455,910
35201下関市　　　　　　,116748,134112,250860,7479,18875,4647,1948
35202宇部市　　　　　　,76823,83840,160663,5424,10809,3297,1334
35203山口市　　　　　　,91589,100646,192235,6625,11373,3748,1318
35204萩市　　　　　　　,20481,23758,44239,879,4511,585,282
35206防府市　　　　　　,54418,58272,112690,4120,7353,2455,910
35207下松市　　　　　　,27004,28294,55298,2479,3315,1341,440
35208岩国市　　　　　　,60146,66980,127126,4018,9855,2577,992
35210光市　　　　　　　,23431,25909,49340,1506,3460,956,336
35211長門市　　　　　　,14866,17192,32058,664,3054,396,191
35212柳井市　　　　　　,14288,16337,30625,719,2672,473,236
35213美祢市　　　　　　,10735,12311,23046,384,2246,267,113
35215周南市　　　　　　,65808,70150,135958,4447,9209,2806,1053
35216山陽小野田市　　　,28247,31388,59635,1782,4275,980,478
35305周防大島町　　　　,6796,7903,14699,203,2221,126,59
35321和木町　　　　　　,2910,3045,5955,281,387,120,53
35341上関町　　　　　　,1082,1256,2338,37,411,13,12
35343田布施町　　　　　,6891,7532,14423,335,1109,170,90
35344平生町　　　　　　,5520,6306,11826,279,967,162,76
35502阿武町　　　　　　,1363,1666,3029,40,385,24,12
36徳島県　　　　　　　 ,341145,372571,713716,22558,51456,13229,5464
3651徳島保健所　　　　 ,226682,247500,474182,16524,29991,9546,3733
3654阿南保健所　　　　 ,37128,39369,76497,2202,5727,1367,543
3655美波保健所　　　　 ,8518,9517,18035,341,2047,199,114
3657吉野川保健所　　　 ,34471,38247,72718,1821,6175,1088,545
3658美馬保健所　　　　 ,16802,18535,35337,814,3572,507,264
3659三好保健所　　　　 ,17544,19403,36947,856,3944,522,265
36201徳島市　　　　　　,119313,131029,250342,9355,15059,5265,1963
36202鳴門市　　　　　　,25728,28522,54250,1332,4050,873,396
36203小松島市　　　　　,17400,18543,35943,990,2510,680,260
36204阿南市　　　　　　,33613,35529,69142,2078,4834,1253,504
36205吉野川市　　　　　,18113,20306,38419,1028,3238,622,272
36206阿波市　　　　　　,16358,17941,34299,793,2937,466,273
36207美馬市　　　　　　,13203,14449,27652,680,2487,397,226
36208三好市　　　　　　,11066,12352,23418,427,2800,307,168
36301勝浦町　　　　　　,2308,2498,4806,99,465,67,25
36302上勝町　　　　　　,649,726,1375,28,183,21,8
36321佐那河内村　　　　,996,1057,2053,35,230,35,17
36341石井町　　　　　　,11695,12887,24582,768,1713,400,192
36342神山町　　　　　　,2167,2426,4593,97,668,80,23
36368那賀町　　　　　　,3515,3840,7355,124,893,114,39
36383牟岐町　　　　　　,1726,1996,3722,49,443,33,20
36387美波町　　　　　　,2907,3261,6168,136,695,70,37
36388海陽町　　　　　　,3885,4260,8145,156,909,96,57
36401松茂町　　　　　　,7149,7314,14463,538,741,374,139
36402北島町　　　　　　,10909,11715,22624,1012,1046,539,164
36403藍住町　　　　　　,16767,18240,35007,1532,1514,830,347
36404板野町　　　　　　,6220,6652,12872,411,916,227,113
36405上板町　　　　　　,5381,5891,11272,327,896,155,86
36468つるぎ町　　　　　,3599,4086,7685,134,1085,110,38
36489東みよし町　　　　,6478,7051,13529,429,1144,215,97
37香川県　　　　　　　 ,452469,484873,937342,31734,62381,19362,7720
3731高松市保健所　　　 ,199451,213140,412591,15544,23357,9628,3642
3752小豆保健所　　　　 ,12593,13910,26503,617,2530,347,133
3757西讃保健所　　　　 ,56711,60948,117659,3579,9410,2099,821
3759東讃保健所　　　　 ,50037,54306,104343,2513,8132,1590,656
3760中讃保健所　　　　 ,133677,142569,276246,9481,18952,5698,2468
37201高松市　　　　　　,199451,213140,412591,15544,23357,9628,3642
37202丸亀市　　　　　　,51820,55621,107441,4159,6372,2433,1065
37203坂出市　　　　　　,23745,25995,49740,1395,4028,891,383
37204善通寺市　　　　　,15574,15780,31354,1108,2060,784,280
37205観音寺市　　　　　,27284,29313,56597,1897,4314,1129,411
37206さぬき市　　　　　,22271,24302,46573,983,3597,661,292
37207東かがわ市　　　　,13287,14751,28038,568,2505,403,167
37208三豊市　　　　　　,29427,31635,61062,1682,5096,970,410
37322土庄町　　　　　　,6020,6747,12767,302,1187,168,54
37324小豆島町　　　　　,6573,7163,13736,315,1343,179,79
37341三木町　　　　　　,12846,13812,26658,852,1817,439,182
37364直島町　　　　　　,1633,1441,3074,110,213,87,15
37386宇多津町　　　　　,8943,9269,18212,918,840,530,195
37387綾川町　　　　　　,10807,11575,22382,620,1755,327,171
37403琴平町　　　　　　,3841,4455,8296,191,807,124,60
37404多度津町　　　　　,10657,10949,21606,632,1563,363,192
37406まんのう町　　　　,8290,8925,17215,458,1527,246,122
38愛媛県　　　　　　　 ,626655,695602,1322257,41461,93287,24732,10190
3831松山市保健所　　　 ,238671,268943,507614,17775,29146,10947,4218
3851四国中央保健所　　 ,40178,41720,81898,2612,5777,1569,656
3855今治保健所　　　　 ,72938,81795,154733,4374,12011,2580,1152
3856中予保健所　　　　 ,59289,66591,125880,3547,8722,1931,854
3863宇和島保健所　　　 ,48451,54789,103240,2431,10100,1511,714
3864西条保健所　　　　 ,104960,113044,218004,7385,15415,4398,1705
3865八幡浜保健所　　　 ,62168,68720,130888,3337,12116,1796,891
38201松山市　　　　　　,238671,268943,507614,17775,29146,10947,4218
38202今治市　　　　　　,69811,78722,148533,4291,11384,2524,1112
38203宇和島市　　　　　,33115,37317,70432,1793,6591,1141,495
38204八幡浜市　　　　　,14906,16869,31775,744,2808,428,198
38205新居浜市　　　　　,55348,59264,114612,3933,8062,2452,896
38206西条市　　　　　　,49612,53780,103392,3452,7353,1946,809
38207大洲市　　　　　　,19371,21032,40403,1191,3297,644,344
38210伊予市　　　　　　,16331,18568,34899,938,2523,486,243
38213四国中央市　　　　,40178,41720,81898,2612,5777,1569,656
38214西予市　　　　　　,16574,18537,35111,886,3575,431,220
38215東温市　　　　　　,16090,17633,33723,986,2069,518,234
38356上島町　　　　　　,3127,3073,6200,83,627,56,40
38386久万高原町　　　　,3501,3869,7370,148,975,97,40
38401松前町　　　　　　,13867,15615,29482,933,1846,526,211
38402砥部町　　　　　　,9500,10906,20406,542,1309,304,126
38422内子町　　　　　　,7299,7970,15269,382,1429,177,95
38442伊方町　　　　　　,4018,4312,8330,134,1007,116,34
38484松野町　　　　　　,1725,1931,3656,80,441,22,21
38488鬼北町　　　　　　,4451,5145,9596,203,1102,114,66
38506愛南町　　　　　　,9160,10396,19556,355,1966,234,132
39高知県　　　　　　　 ,324153,362829,686982,20722,52461,12250,5724
3931高知市保健所　　　 ,151556,173253,324809,11029,19823,6772,3080
3954幡多保健所　　　　 ,37742,42078,79820,2021,7282,1198,628
3961須崎保健所　　　　 ,24091,26155,50246,1160,5214,643,323
3962中央東保健所　　　 ,55089,59931,115020,3642,8777,1876,875
3963中央西保健所　　　 ,35025,38698,73723,1946,6846,1125,503
3964安芸保健所　　　　 ,20650,22714,43364,924,4519,636,315
39201高知市　　　　　　,151556,173253,324809,11029,19823,6772,3080
39202室戸市　　　　　　,5572,6079,11651,204,1372,158,82
39203安芸市　　　　　　,7727,8448,16175,371,1484,246,112
39204南国市　　　　　　,22011,24355,46366,1669,2947,841,390
39205土佐市　　　　　　,12178,13189,25367,838,2052,468,203
39206須崎市　　　　　　,9798,10400,20198,457,1766,275,131
39208宿毛市　　　　　　,8895,10069,18964,493,1592,269,160
39209土佐清水市　　　　,5799,6510,12309,172,1412,131,89
39210四万十市　　　　　,15417,17180,32597,1046,2502,583,268
39211香南市　　　　　　,15374,16522,31896,1089,2203,580,266
39212香美市　　　　　　,12694,13521,26215,656,2252,338,169
39301東洋町　　　　　　,1054,1099,2153,38,299,25,13
39302奈半利町　　　　　,1393,1630,3023,74,314,51,40
39303田野町　　　　　　,1174,1317,2491,67,218,45,11
39304安田町　　　　　　,1141,1224,2365,46,286,25,11
39305北川村　　　　　　,550,593,1143,24,126,23,11
39306馬路村　　　　　　,356,387,743,17,74,16,7
39307芸西村　　　　　　,1683,1937,3620,83,346,47,28
39341本山町　　　　　　,1511,1728,3239,68,381,38,11
39344大豊町　　　　　　,1535,1684,3219,51,499,38,17
39363土佐町　　　　　　,1776,1944,3720,94,450,41,21
39364大川村　　　　　　,188,177,365,15,45,-,1
39386いの町　　　　　　,10159,11176,21335,519,1889,304,139
39387仁淀川町　　　　　,2287,2502,4789,95,722,46,27
39401中土佐町　　　　　,2750,3210,5960,103,732,55,40
39402佐川町　　　　　　,5737,6530,12267,271,1127,173,68
39403越知町　　　　　　,2387,2784,5171,114,626,65,33
39405檮原町　　　　　　,1607,1695,3302,87,333,55,23
39410日高村　　　　　　,2277,2517,4794,109,430,69,33
39411津野町　　　　　　,2511,2752,5263,128,591,80,38
39412四万十町　　　　　,7425,8098,15523,385,1792,178,91
39424大月町　　　　　　,2115,2300,4415,66,561,61,33
39427三原村　　　　　　,685,739,1424,25,178,14,6
39428黒潮町　　　　　　,4831,5280,10111,219,1037,140,72
40福岡県　　　　　　　 ,2389133,2666323,5055456,194238,278393,117636,45361
4008福岡市中央保健所　 ,89873,110632,200505,7852,6504,7422,1743
4009福岡市博多保健所　 ,116779,125827,242606,11300,9361,10852,2475
4010福岡市南保健所　　 ,119382,139874,259256,10931,11447,6784,2292
4011福岡市早良保健所　 ,102762,115947,218709,8426,9683,4574,1812
4012福岡市東保健所　　 ,150996,160780,311776,13462,13406,8368,2820
4013福岡市西保健所　　 ,99117,110195,209312,8514,9315,4587,1644
4014福岡市城南保健所　 ,61618,69939,131557,4554,5771,2579,955
4015北九州市保健所　　 ,435418,489297,924715,32466,58607,20921,8429
4042久留米市保健所　　 ,142789,156431,299220,12510,16925,6943,2737
4057宗像・遠賀保健所　 ,138228,155230,293458,11057,17369,5679,2508
4058粕屋保健所　　　　 ,140014,149036,289050,13187,12739,6545,2990
4059筑紫保健所　　　　 ,208383,228095,436478,18408,18351,9516,3834
4060糸島保健所　　　　 ,46361,51336,97697,3329,5300,1539,841
4065田川保健所　　　　 ,53863,63301,117164,3710,10478,2107,1367
4068北筑後保健所　　　 ,85765,96411,182176,6229,11593,3197,1429
4074南筑後保健所　　　 ,180492,204131,384623,12467,29110,6703,3051
4075京築保健所　　　　 ,87185,93573,180758,6432,11987,3770,1747
4077嘉穂・鞍手保健所　 ,130108,146288,276396,9404,20447,5550,2687
40100北九州市　　　　　,435418,489297,924715,32466,58607,20921,8429
40101北九州市門司区　　,42576,50414,92990,2518,7527,1626,795
40103北九州市若松区　　,37539,41779,79318,2552,5369,1404,667
40105北九州市戸畑区　　,27598,29077,56675,2021,3698,1259,425
40106北九州市小倉北区　,83235,94745,177980,6949,10905,5380,1795
40107北九州市小倉南区　,98588,108687,207275,7833,11355,4595,2038
40108北九州市八幡東区　,29956,34028,63984,1767,5024,1282,445
40109北九州市八幡西区　,115926,130567,246493,8826,14729,5375,2264
40130福岡市　　　　　　,740527,833194,1573721,65039,65487,45166,13741
40131福岡市東区　　　　,150996,160780,311776,13462,13406,8368,2820
40132福岡市博多区　　　,116779,125827,242606,11300,9361,10852,2475
40133福岡市中央区　　　,89873,110632,200505,7852,6504,7422,1743
40134福岡市南区　　　　,119382,139874,259256,10931,11447,6784,2292
40135福岡市西区　　　　,99117,110195,209312,8514,9315,4587,1644
40136福岡市城南区　　　,61618,69939,131557,4554,5771,2579,955
40137福岡市早良区　　　,102762,115947,218709,8426,9683,4574,1812
40202大牟田市　　　　　,50967,59576,110543,3325,9455,1933,962
40203久留米市　　　　　,142789,156431,299220,12510,16925,6943,2737
40204直方市　　　　　　,26047,29574,55621,1982,3859,1160,556
40205飯塚市　　　　　　,59441,65572,125013,4717,8338,2811,1267
40206田川市　　　　　　,20849,24888,45737,1613,3574,909,571
40207柳川市　　　　　　,30156,33767,63923,1930,4697,1048,475
40210八女市　　　　　　,28300,31826,60126,2014,4856,1017,439
40211筑後市　　　　　　,23204,25100,48304,2099,2677,1057,431
40212大川市　　　　　　,15318,17432,32750,983,2568,573,266
40213行橋市　　　　　　,33807,36971,70778,2827,4241,1603,760
40214豊前市　　　　　　,11197,12853,24050,672,2027,342,190
40215中間市　　　　　　,18746,21268,40014,1208,3103,734,430
40216小郡市　　　　　　,27371,31070,58441,1855,2925,942,384
40217筑紫野市　　　　　,48936,53742,102678,4521,4640,2331,843
40218春日市　　　　　　,52643,57518,110161,4246,4230,2330,1031
40219大野城市　　　　　,48358,52829,101187,4881,3975,2420,897
40220宗像市　　　　　　,45853,50466,96319,3699,5022,1864,766
40221太宰府市　　　　　,34444,38189,72633,2713,3489,1465,561
40223古賀市　　　　　　,27570,30419,57989,2205,2737,1136,532
40224福津市　　　　　　,31080,35544,66624,3186,3305,1393,514
40225うきは市　　　　　,13036,14700,27736,843,2203,476,230
40226宮若市　　　　　　,12176,13752,25928,921,2196,489,240
40227嘉麻市　　　　　　,16278,18936,35214,884,3233,510,316
40228朝倉市　　　　　　,23241,26310,49551,1518,3653,873,359
40229みやま市　　　　　,16605,18995,35600,951,2912,512,223
40230糸島市　　　　　　,46361,51336,97697,3329,5300,1539,841
40231那珂川市　　　　　,24002,25817,49819,2047,2017,970,502
40341宇美町　　　　　　,18624,18546,37170,1333,1907,661,400
40342篠栗町　　　　　　,14903,16116,31019,1353,1443,732,328
40343志免町　　　　　　,21988,23772,45760,2019,1980,978,526
40344須恵町　　　　　　,13544,14778,28322,1261,1427,590,298
40345新宮町　　　　　　,15705,16780,32485,1652,1120,703,295
40348久山町　　　　　　,4241,4573,8814,382,482,129,86
40349粕屋町　　　　　　,23439,24052,47491,2982,1643,1616,525
40381芦屋町　　　　　　,6579,6880,13459,415,926,291,112
40382水巻町　　　　　　,12871,14813,27684,1030,1883,617,268
40383岡垣町　　　　　　,14393,16444,30837,921,2002,444,232
40384遠賀町　　　　　　,8706,9815,18521,598,1128,336,186
40401小竹町　　　　　　,3246,3709,6955,135,654,107,68
40402鞍手町　　　　　　,6952,7937,14889,324,1263,218,118
40421桂川町　　　　　　,5968,6808,12776,441,904,255,122
40447筑前町　　　　　　,13966,15395,29361,1207,1728,582,297
40448東峰村　　　　　　,861,1027,1888,45,236,22,12
40503大刀洗町　　　　　,7290,7909,15199,761,848,302,147
40522大木町　　　　　　,6504,7195,13699,496,777,232,104
40544広川町　　　　　　,9438,10240,19678,669,1168,331,151
40601香春町　　　　　　,4713,5429,10142,265,996,154,95
40602添田町　　　　　　,4125,4667,8792,174,932,111,71
40604糸田町　　　　　　,3821,4548,8369,271,785,165,110
40605川崎町　　　　　　,6874,8203,15077,459,1470,277,180
40608大任町　　　　　　,2262,2737,4999,192,513,90,71
40609赤村　　　　　　　,1294,1477,2771,72,303,56,26
40610福智町　　　　　　,9925,11352,21277,664,1905,345,243
40621苅田町　　　　　　,18770,17701,36471,1577,1787,954,403
40625みやこ町　　　　　,8712,9966,18678,451,1557,250,129
40642吉富町　　　　　　,3036,3442,6478,262,396,135,68
40646上毛町　　　　　　,3439,3778,7217,175,564,86,55
40647築上町　　　　　　,8224,8862,17086,468,1415,400,142
41佐賀県　　　　　　　 ,381635,423243,804878,30175,51391,15817,6072
4153鳥栖保健所　　　　 ,59448,64964,124412,5166,6585,2523,992
4155唐津保健所　　　　 ,57919,64312,122231,4464,8918,2337,1036
4156伊万里保健所　　　 ,33844,37200,71044,2476,5027,1254,588
4159佐賀中部保健所　　 ,161286,179057,340343,12781,20173,6938,2515
4160杵藤保健所　　　　 ,69138,77710,146848,5288,10688,2765,941
41201佐賀市　　　　　　,109423,122181,231604,8561,13483,4643,1677
41202唐津市　　　　　　,54855,61775,116630,4320,8483,2195,990
41203鳥栖市　　　　　　,34797,38060,72857,3161,3494,1625,600
41204多久市　　　　　　,8472,9658,18130,507,1466,304,122
41205伊万里市　　　　　,25122,27056,52178,1943,3674,981,444
41206武雄市　　　　　　,22648,25044,47692,1889,3160,1001,316
41207鹿島市　　　　　　,13076,14659,27735,995,1900,501,206
41208小城市　　　　　　,20666,23009,43675,1894,2512,922,358
41209嬉野市　　　　　　,11925,13762,25687,848,1935,461,157
41210神埼市　　　　　　,14796,16009,30805,1066,1968,607,209
41327吉野ヶ里町　　　　,7929,8200,16129,753,744,462,149
41341基山町　　　　　　,8099,8893,16992,593,911,269,112
41345上峰町　　　　　　,4443,4784,9227,448,455,213,78
41346みやき町　　　　　,12109,13227,25336,964,1725,416,202
41387玄海町　　　　　　,3064,2537,5601,144,435,142,46
41401有田町　　　　　　,8722,10144,18866,533,1353,273,144
41423大町町　　　　　　,2898,3379,6277,175,579,106,38
41424江北町　　　　　　,4449,5050,9499,530,607,245,68
41425白石町　　　　　　,10322,11572,21894,605,1786,334,118
41441太良町　　　　　　,3820,4244,8064,246,721,117,38
42長崎県　　　　　　　 ,612353,690714,1303067,46128,90529,24880,9728
4233佐世保市保健所　　 ,114058,127340,241398,9220,16708,5369,2103
4234長崎市保健所　　　 ,186788,219076,405864,13315,26848,7799,3062
4261壱岐保健所　　　　 ,11819,13050,24869,739,2280,366,168
4264西彼保健所　　　　 ,45880,49690,95570,3799,5518,1806,649
4265県央保健所　　　　 ,125105,138092,263197,10612,15237,5437,2023
4266県南保健所　　　　 ,58896,66817,125713,3939,10713,1848,717
4267県北保健所　　　　 ,30464,33641,64105,2218,5470,1042,414
4268五島保健所　　　　 ,16093,18170,34263,974,3334,496,210
4269上五島保健所　　　 ,9259,10481,19740,440,2072,227,140
4270対馬保健所　　　　 ,13991,14357,28348,872,2349,490,242
42201長崎市　　　　　　,186788,219076,405864,13315,26848,7799,3062
42202佐世保市　　　　　,114058,127340,241398,9220,16708,5369,2103
42203島原市　　　　　　,20037,22937,42974,1464,3314,653,268
42204諫早市　　　　　　,63192,69794,132986,4877,8093,2530,962
42205大村市　　　　　　,45233,49758,94991,4524,4682,2334,827
42207平戸市　　　　　　,13705,15505,29210,879,2879,413,160
42208松浦市　　　　　　,10187,10844,21031,632,1843,337,129
42209対馬市　　　　　　,13991,14357,28348,872,2349,490,242
42210壱岐市　　　　　　,11819,13050,24869,739,2280,366,168
42211五島市　　　　　　,16093,18170,34263,974,3334,496,210
42212西海市　　　　　　,12747,13070,25817,773,2365,405,148
42213雲仙市　　　　　　,19297,21371,40668,1322,3345,665,214
42214南島原市　　　　　,19562,22509,42071,1153,4054,530,235
42307長与町　　　　　　,19144,21474,40618,1704,1801,766,290
42308時津町　　　　　　,13989,15146,29135,1322,1352,635,211
42321東彼杵町　　　　　,3667,4012,7679,175,612,90,29
42322川棚町　　　　　　,6269,7010,13279,437,885,231,104
42323波佐見町　　　　　,6744,7518,14262,599,965,252,101
42383小値賀町　　　　　,1052,1230,2282,44,280,13,18
42391佐々町　　　　　　,6572,7292,13864,707,748,292,125
42411新上五島町　　　　,8207,9251,17458,396,1792,214,122
43熊本県　　　　　　　 ,815405,906600,1722005,65162,110726,34897,13878
4301熊本市保健所　　　 ,345813,386383,732196,31045,36955,17337,6228
4354山鹿保健所　　　　 ,22905,25755,48660,1576,4113,865,378
4355菊池保健所　　　　 ,89740,95232,184972,8765,8859,4093,1647
4356阿蘇保健所　　　　 ,27799,30109,57908,1688,4870,974,441
4357御船保健所　　　　 ,38944,42570,81514,3020,5674,1581,611
4360八代保健所　　　　 ,61908,69905,131813,4178,10047,2220,1068
4361水俣保健所　　　　 ,20245,23143,43388,1126,3979,605,292
4362人吉保健所　　　　 ,37837,43104,80941,2440,7081,1213,603
4365有明保健所　　　　 ,71736,80132,151868,5009,11590,2568,1168
4366宇城保健所　　　　 ,48315,53456,101771,3407,7389,1885,802
4367天草保健所　　　　 ,50163,56811,106974,2908,10169,1556,640
43100熊本市　　　　　　,345813,386383,732196,31045,36955,17337,6228
43101熊本市中央区　　　,87121,97497,184618,6947,8749,4761,1491
43102熊本市東区　　　　,89006,99229,188235,8545,8387,4522,1635
43103熊本市西区　　　　,42436,47992,90428,3420,5647,1959,706
43104熊本市南区　　　　,61263,68776,130039,6447,6575,2805,1180
43105熊本市北区　　　　,65987,72889,138876,5686,7597,3290,1216
43202八代市　　　　　　,56837,64037,120874,3897,9060,2071,988
43203人吉市　　　　　　,14291,16628,30919,989,2548,558,248
43204荒尾市　　　　　　,23736,26778,50514,1653,3840,898,429
43205水俣市　　　　　　,10893,12598,23491,652,1973,366,154
43206玉名市　　　　　　,29868,33553,63421,2220,4552,1103,441
43208山鹿市　　　　　　,22905,25755,48660,1576,4113,865,378
43210菊池市　　　　　　,21881,23914,45795,1631,3290,849,404
43211宇土市　　　　　　,17186,18721,35907,1332,2191,700,288
43212上天草市　　　　　,11468,12999,24467,648,2306,364,135
43213宇城市　　　　　　,26793,29742,56535,1924,4167,1077,463
43214阿蘇市　　　　　　,11640,12877,24517,717,2100,461,186
43215天草市　　　　　　,35313,40144,75457,2112,7223,1102,460
43216合志市　　　　　　,29553,31948,61501,3045,2712,1174,533
43348美里町　　　　　　,4336,4993,9329,151,1031,108,51
43364玉東町　　　　　　,2382,2637,5019,156,350,60,43
43367南関町　　　　　　,4185,4647,8832,252,808,116,58
43368長洲町　　　　　　,7191,7588,14779,505,1046,263,126
43369和水町　　　　　　,4374,4929,9303,223,994,128,71
43403大津町　　　　　　,17288,17476,34764,1733,1456,877,331
43404菊陽町　　　　　　,21018,21894,42912,2356,1401,1193,379
43423南小国町　　　　　,1745,1934,3679,118,382,66,31
43424小国町　　　　　　,3132,3417,6549,200,535,92,35
43425産山村　　　　　　,695,660,1355,34,138,19,7
43428高森町　　　　　　,2768,2959,5727,159,513,77,52
43432西原村　　　　　　,3085,3254,6339,208,375,107,51
43433南阿蘇村　　　　　,4734,5008,9742,252,827,152,79
43441御船町　　　　　　,7731,8500,16231,571,1130,318,134
43442嘉島町　　　　　　,4511,4932,9443,503,564,215,70
43443益城町　　　　　　,15546,16821,32367,1388,1678,695,258
43444甲佐町　　　　　　,4766,5307,10073,273,782,151,79
43447山都町　　　　　　,6390,7010,13400,285,1520,202,70
43468氷川町　　　　　　,5071,5868,10939,281,987,149,80
43482芦北町　　　　　　,7362,8288,15650,367,1607,187,104
43484津奈木町　　　　　,1990,2257,4247,107,399,52,34
43501錦町　　　　　　　,4866,5373,10239,400,738,169,84
43505多良木町　　　　　,4242,4773,9015,211,808,102,51
43506湯前町　　　　　　,1698,1924,3622,82,421,41,18
43507水上村　　　　　　,937,1089,2026,62,190,19,7
43510相良村　　　　　　,1919,2136,4055,98,383,44,24
43511五木村　　　　　　,447,481,928,19,109,13,6
43512山江村　　　　　　,1497,1736,3233,107,241,38,32
43513球磨村　　　　　　,1174,1258,2432,54,406,32,23
43514あさぎり町　　　　,6766,7706,14472,418,1237,197,110
43531苓北町　　　　　　,3382,3668,7050,148,640,90,45
44大分県　　　　　　　 ,527592,584000,1111592,37531,74920,22319,9135
4431大分市保健所　　　 ,226657,245637,472294,18741,23219,10972,4206
4456中部保健所　　　　 ,39821,44481,84302,2294,7037,1431,572
4457南部保健所　　　　 ,30709,35803,66512,1682,5662,1030,520
4458豊肥保健所　　　　 ,25096,28473,53569,1115,5407,719,340
4462北部保健所　　　　 ,74341,80563,154904,5312,11560,2982,1300
4465西部保健所　　　　 ,40424,44541,84965,2639,7000,1498,650
4467東部保健所　　　　 ,90544,104502,195046,5748,15035,3687,1547
44201大分市　　　　　　,226657,245637,472294,18741,23219,10972,4206
44202別府市　　　　　　,50791,61125,111916,3404,8184,2252,954
44203中津市　　　　　　,39330,41953,81283,3098,5393,1817,741
44204日田市　　　　　　,29504,32726,62230,2002,4937,1071,480
44205佐伯市　　　　　　,30709,35803,66512,1682,5662,1030,520
44206臼杵市　　　　　　,16858,18985,35843,787,3064,501,227
44207津久見市　　　　　,7487,8579,16066,318,1498,222,96
44208竹田市　　　　　　,9453,10639,20092,387,2111,266,138
44209豊後高田市　　　　,10342,11147,21489,688,1866,324,165
44210杵築市　　　　　　,13346,14483,27829,729,2337,473,210
44211宇佐市　　　　　　,24669,27463,52132,1526,4301,841,394
44212豊後大野市　　　　,15643,17834,33477,728,3296,453,202
44213由布市　　　　　　,15476,16917,32393,1189,2475,708,249
44214国東市　　　　　　,12437,13547,25984,554,2686,386,153
44322姫島村　　　　　　,802,920,1722,28,191,24,9
44341日出町　　　　　　,13168,14427,27595,1033,1637,552,221
44461九重町　　　　　　,3999,4456,8455,211,815,114,55
44462玖珠町　　　　　　,6921,7359,14280,426,1248,313,115
45宮崎県　　　　　　　 ,501859,560714,1062573,38923,72540,21108,9516
4531宮崎市保健所　　　 ,188093,210779,398872,15759,21419,8773,3650
4552都城保健所　　　　 ,86702,97867,184569,7561,12778,3913,1655
4553延岡保健所　　　　 ,55868,62063,117931,4116,8845,2345,1043
4554日南保健所　　　　 ,31527,35664,67191,1987,6114,1070,612
4555小林保健所　　　　 ,32649,36634,69283,2099,6169,1094,583
4556高鍋保健所　　　　 ,45394,50086,95480,3143,7230,1640,810
4557高千穂保健所　　　 ,9028,9677,18705,489,1812,253,126
4559日向保健所　　　　 ,40800,44557,85357,3017,6277,1700,806
4561中央保健所　　　　 ,11798,13387,25185,752,1896,320,231
45201宮崎市　　　　　　,188093,210779,398872,15759,21419,8773,3650
45202都城市　　　　　　,74823,84312,159135,6403,11346,3472,1441
45203延岡市　　　　　　,55868,62063,117931,4116,8845,2345,1043
45204日南市　　　　　　,23667,26778,50445,1513,4358,825,479
45205小林市　　　　　　,20215,22947,43162,1447,3483,727,377
45206日向市　　　　　　,28237,31039,59276,2182,3920,1227,594
45207串間市　　　　　　,7860,8886,16746,474,1756,245,133
45208西都市　　　　　　,13383,15133,28516,874,2403,442,232
45209えびの市　　　　　,8318,9187,17505,436,1865,256,143
45341三股町　　　　　　,11879,13555,25434,1158,1432,441,214
45361高原町　　　　　　,4116,4500,8616,216,821,111,63
45382国富町　　　　　　,8538,9730,18268,513,1405,230,156
45383綾町　　　　　　　,3260,3657,6917,239,491,90,75
45401高鍋町　　　　　　,9473,10391,19864,723,1354,379,201
45402新富町　　　　　　,8030,8380,16410,585,1018,395,141
45403西米良村　　　　　,491,508,999,33,115,20,3
45404木城町　　　　　　,2247,2642,4889,157,450,48,48
45405川南町　　　　　　,7117,7840,14957,439,1099,201,106
45406都農町　　　　　　,4653,5192,9845,332,791,155,79
45421門川町　　　　　　,8235,9049,17284,605,1281,335,174
45429諸塚村　　　　　　,724,760,1484,41,149,18,5
45430椎葉村　　　　　　,1268,1231,2499,78,250,53,16
45431美郷町　　　　　　,2336,2478,4814,111,677,67,17
45441高千穂町　　　　　,5591,6019,11610,322,1055,165,79
45442日之影町　　　　　,1744,1888,3632,95,420,46,21
45443五ケ瀬町　　　　　,1693,1770,3463,72,337,42,26
46鹿児島県　　　　　　 ,744313,832709,1577022,58729,111345,31289,13066
4633鹿児島市保健所　　 ,274496,315422,589918,24123,32155,13452,4881
4651指宿保健所　　　　 ,18041,20615,38656,1147,3182,561,284
4652加世田保健所　　　 ,39508,45524,85032,2353,8115,1148,495
4653伊集院保健所　　　 ,35250,40000,75250,2318,5702,1085,478
4656出水保健所　　　　 ,37771,42193,79964,2747,6482,1347,690
4657大口保健所　　　　 ,11287,13037,24324,762,2544,403,178
4660志布志保健所　　　 ,35191,38807,73998,2207,7026,1106,549
4661鹿屋保健所　　　　 ,70731,76889,147620,5602,12212,2921,1306
4662西之表保健所　　　 ,13289,14294,27583,857,2459,457,220
4663屋久島保健所　　　 ,5771,5985,11756,358,913,205,125
4664名瀬保健所　　　　 ,31444,33742,65186,2294,5456,1313,676
4665徳之島保健所　　　 ,19176,19470,38646,1443,3661,693,373
4666川薩保健所　　　　 ,53773,57967,111740,4170,8432,2250,877
4667姶良保健所　　　　 ,98585,108764,207349,8348,13006,4348,1934
46201鹿児島市　　　　　,274496,315422,589918,24123,32155,13452,4881
46203鹿屋市　　　　　　,48181,52282,100463,4440,6735,2314,1007
46204枕崎市　　　　　　,9140,10517,19657,463,1775,243,136
46206阿久根市　　　　　,9028,10122,19150,483,1933,286,142
46208出水市　　　　　　,24067,27120,51187,1857,3642,898,479
46210指宿市　　　　　　,18041,20615,38656,1147,3182,561,284
46213西之表市　　　　　,7024,7607,14631,423,1298,246,103
46214垂水市　　　　　　,6361,7193,13554,305,1474,178,77
46215薩摩川内市　　　　,44441,47461,91902,3681,6444,1984,758
46216日置市　　　　　　,21991,24842,46833,1557,3574,708,297
46217曽於市　　　　　　,15487,17460,32947,858,3344,427,207
46218霧島市　　　　　　,58602,63748,122350,5062,7287,2693,1185
46219いちき串木野市　　,12666,14618,27284,713,2068,366,176
46220南さつま市　　　　,15058,17609,32667,951,3119,466,177
46221志布志市　　　　　,13887,15082,28969,1010,2552,500,247
46222奄美市　　　　　　,19728,21557,41285,1454,3140,875,467
46223南九州市　　　　　,15310,17398,32708,939,3221,439,182
46224伊佐市　　　　　　,11287,13037,24324,762,2544,403,178
46225姶良市　　　　　　,35597,40371,75968,3062,4809,1541,690
46303三島村　　　　　　,189,213,402,17,14,4,2
46304十島村　　　　　　,404,327,731,31,46,7,3
46392さつま町　　　　　,9332,10506,19838,489,1988,266,119
46404長島町　　　　　　,4676,4951,9627,407,907,163,69
46452湧水町　　　　　　,4386,4645,9031,224,910,114,59
46468大崎町　　　　　　,5817,6265,12082,339,1130,179,95
46482東串良町　　　　　,2922,3189,6111,195,643,91,47
46490錦江町　　　　　　,3246,3629,6875,165,901,80,33
46491南大隅町　　　　　,3073,3385,6458,136,891,67,27
46492肝付町　　　　　　,6948,7211,14159,361,1568,191,115
46501中種子町　　　　　,3545,3975,7520,262,693,131,69
46502南種子町　　　　　,2720,2712,5432,172,468,80,48
46505屋久島町　　　　　,5771,5985,11756,358,913,205,125
46523大和村　　　　　　,672,691,1363,49,174,28,9
46524宇検村　　　　　　,788,829,1617,41,174,20,10
46525瀬戸内町　　　　　,4204,4327,8531,309,823,177,78
46527龍郷町　　　　　　,2802,2998,5800,244,528,109,56
46529喜界町　　　　　　,3250,3340,6590,197,617,104,56
46530徳之島町　　　　　,4961,5145,10106,443,913,199,109
46531天城町　　　　　　,2787,2700,5487,211,610,88,53
46532伊仙町　　　　　　,3067,3048,6115,215,645,110,65
46533和泊町　　　　　　,3047,3091,6138,220,553,109,49
46534知名町　　　　　　,2857,2840,5697,194,532,95,53
46535与論町　　　　　　,2457,2646,5103,160,408,92,44
47沖縄県　　　　　　　 ,711068,736177,1447245,73706,65692,36856,16919
4731那覇市保健所　　　 ,151140,160837,311977,13442,14915,7531,3304
4751北部保健所　　　　 ,50202,49662,99864,4759,5576,2290,1078
4755南部保健所　　　　 ,206435,212772,419207,23375,17069,10410,4698
4756宮古保健所　　　　 ,26853,26609,53462,2537,3501,1317,739
4757八重山保健所　　　 ,26592,26047,52639,2862,2534,1598,747
4758中部保健所　　　　 ,249846,260250,510096,26731,22097,13710,6353
47201那覇市　　　　　　,151140,160837,311977,13442,14915,7531,3304
47205宜野湾市　　　　　,47858,50524,98382,5662,3563,3003,1234
47207石垣市　　　　　　,23655,23408,47063,2544,2230,1436,681
47208浦添市　　　　　　,55221,59246,114467,6027,4146,3114,1309
47209名護市　　　　　　,31317,31653,62970,3376,2813,1630,723
47210糸満市　　　　　　,30100,30013,60113,3435,2759,1413,705
47211沖縄市　　　　　　,68063,72505,140568,7473,5995,3809,1893
47212豊見城市　　　　　,31239,32981,64220,3895,2278,1629,715
47213うるま市　　　　　,62096,61848,123944,6370,5746,3000,1538
47214宮古島市　　　　　,26279,26136,52415,2510,3438,1305,731
47215南城市　　　　　　,22013,21769,43782,2145,2317,915,460
47301国頭村　　　　　　,2297,2188,4485,148,367,81,38
47302大宜味村　　　　　,1629,1440,3069,85,265,35,21
47303東村　　　　　　　,875,712,1587,65,120,36,20
47306今帰仁村　　　　　,4441,4409,8850,347,665,158,103
47308本部町　　　　　　,6266,6128,12394,471,857,237,124
47311恩納村　　　　　　,5097,5029,10126,344,551,250,125
47313宜野座村　　　　　,2873,2917,5790,333,342,169,70
47314金武町　　　　　　,5310,5395,10705,536,693,339,147
47315伊江村　　　　　　,2066,2026,4092,159,293,72,34
47324読谷村　　　　　　,19810,20638,40448,1857,1814,942,412
47325嘉手納町　　　　　,6505,6915,13420,619,720,327,175
47326北谷町　　　　　　,13026,14307,27333,1435,1123,911,371
47327北中城村　　　　　,8407,9161,17568,823,705,389,200
47328中城村　　　　　　,10801,11011,21812,1279,845,571,188
47329西原町　　　　　　,17207,17202,34409,1518,1257,727,383
47348与那原町　　　　　,9496,10086,19582,1267,760,563,229
47350南風原町　　　　　,19661,20552,40213,2769,1333,1077,442
47353渡嘉敷村　　　　　,383,329,712,39,27,27,7
47354座間味村　　　　　,476,401,877,42,44,21,19
47355粟国村　　　　　　,384,297,681,18,68,11,-
47356渡名喜村　　　　　,205,139,344,8,32,4,6
47357南大東村　　　　　,732,522,1254,55,65,37,19
47358北大東村　　　　　,364,221,585,27,13,10,9
47359伊平屋村　　　　　,606,512,1118,54,72,16,8
47360伊是名村　　　　　,705,594,1299,54,124,25,7
47361久米島町　　　　　,3804,3353,7157,323,556,151,86
47362八重瀬町　　　　　,15150,15661,30811,1807,1414,711,309
47375多良間村　　　　　,574,473,1047,27,63,12,8
47381竹富町　　　　　　,2024,1891,3915,244,211,120,50
47382与那国町　　　　　,913,748,1661,74,93,42,16
